id,Geographic Area Name,Estimate!!SEX AND AGE!!Total population,Estimate!!SEX AND AGE!!Total population!!Male,Estimate!!SEX AND AGE!!Total population!!Female,Estimate!!SEX AND AGE!!Under 5 years,Estimate!!SEX AND AGE!!5 to 9 years,Estimate!!SEX AND AGE!!10 to 14 years,Estimate!!SEX AND AGE!!15 to 19 years,Estimate!!SEX AND AGE!!20 to 24 years,Estimate!!SEX AND AGE!!25 to 34 years,Estimate!!SEX AND AGE!!35 to 44 years,Estimate!!SEX AND AGE!!45 to 54 years,Estimate!!SEX AND AGE!!55 to 59 years,Estimate!!SEX AND AGE!!60 to 64 years,Estimate!!SEX AND AGE!!65 to 74 years,Estimate!!SEX AND AGE!!75 to 84 years,Estimate!!SEX AND AGE!!85 years and over,Estimate!!SEX AND AGE!!Median age (years),Estimate!!SEX AND AGE!!18 years and over,Estimate!!SEX AND AGE!!21 years and over,Estimate!!SEX AND AGE!!62 years and over,Estimate!!SEX AND AGE!!65 years and over,Estimate!!SEX AND AGE!!18 years and over,Estimate!!SEX AND AGE!!18 years and over!!Male,Estimate!!SEX AND AGE!!18 years and over!!Female,Estimate!!SEX AND AGE!!65 years and over,Estimate!!SEX AND AGE!!65 years and over!!Male,Estimate!!SEX AND AGE!!65 years and over!!Female
0500000US01003,"Baldwin County, Alabama",208563,100902,107661,10938,13516,13190,13478,10454,24663,23384,28689,14891,14739,24102,12609,3910,42.4,162608,154216,49785,40621,162608,77620,84988,40621,18755,21866
0500000US01015,"Calhoun County, Alabama",114611,55491,59120,6073,7297,6896,8122,8005,14623,14083,14990,7457,8103,11229,5570,2163,39.1,89658,84395,24443,18962,89658,42513,47145,18962,8002,10960
0500000US01043,"Cullman County, Alabama",82471,40699,41772,4856,4650,5206,5069,5221,10351,10056,11146,5507,5325,9125,4692,1267,40.4,64471,61358,17760,15084,64471,31628,32843,15084,6666,8418
0500000US01049,"DeKalb County, Alabama",70900,34509,36391,3951,4220,5518,5587,3397,8571,9329,9552,4481,4430,7460,3560,844,39.8,53791,50606,14257,11864,53791,26115,27676,11864,4953,6911
0500000US01051,"Elmore County, Alabama",81799,39956,41843,4284,5826,5481,4533,5451,11622,10823,11361,5945,4483,7416,2960,1614,38.3,63172,60367,13865,11990,63172,30090,33082,11990,5354,6636
0500000US01055,"Etowah County, Alabama",102564,49861,52703,5505,5900,6703,7137,6215,11409,12262,14527,8888,5333,11157,5544,1984,41.2,79902,75741,21608,18685,79902,38102,41800,18685,7996,10689
0500000US01069,"Houston County, Alabama",104056,50015,54041,6221,6912,6867,6673,5914,13593,12681,13861,7748,6083,10210,5432,1861,39.5,79619,76305,20852,17503,79619,37213,42406,17503,7437,10066
0500000US01073,"Jefferson County, Alabama",659521,310913,348608,42831,42675,41278,40998,42627,95118,83165,83696,46027,41225,57279,29423,13179,38,507739,482044,123762,99881,507739,233963,273776,99881,40491,59390
0500000US01077,"Lauderdale County, Alabama",92318,45121,47197,4944,4888,5052,6810,7304,10704,10779,11550,6579,6553,9784,5091,2280,41.6,73393,68201,20632,17155,73393,34631,38762,17155,7575,9580
0500000US01081,"Lee County, Alabama",158991,79257,79734,9170,10417,8797,13761,21850,23465,17921,19720,9102,7212,11038,4984,1554,31,124912,111780,21954,17576,124912,60909,64003,17576,7831,9745
0500000US01083,"Limestone County, Alabama",92753,47635,45118,4701,5407,6813,6970,4951,12571,12241,14044,6415,5197,8496,3112,1835,38.8,71433,68246,17347,13443,71433,35499,35934,13443,6021,7422
0500000US01089,"Madison County, Alabama",356967,174569,182398,20121,23603,21283,23256,24816,48747,44813,50994,27223,20615,29597,15996,5903,38.8,278114,262698,64051,51496,278114,134123,143991,51496,22662,28834
0500000US01095,"Marshall County, Alabama",95157,46338,48819,6254,6553,6529,6278,5153,12517,11469,12204,6539,5671,9461,5624,905,38,71657,68778,19555,15990,71657,34497,37160,15990,6831,9159
0500000US01097,"Mobile County, Alabama",414836,197818,217018,26896,26942,27095,27545,27817,57734,49476,52835,28339,26534,38279,18062,7282,37.4,316517,300748,80504,63623,316517,148518,167999,63623,27359,36264
0500000US01101,"Montgomery County, Alabama",226349,107250,119099,15417,16197,12193,15134,16351,33610,28374,28524,15254,13446,18468,9661,3720,36.4,173781,164525,39533,31849,173781,80390,93391,31849,13246,18603
0500000US01103,"Morgan County, Alabama",119012,59211,59801,6751,8418,6649,8844,6138,13931,15726,16746,8615,7025,11920,5770,2479,40.7,91671,86797,24539,20169,91671,44531,47140,20169,8766,11403
0500000US01115,"St. Clair County, Alabama",88019,44199,43820,5325,5045,6223,4911,5110,11539,11032,13041,6208,5164,8459,4466,1496,40.3,67803,65559,18311,14421,67803,33347,34456,14421,6482,7939
0500000US01117,"Shelby County, Alabama",210622,101886,108736,12480,12687,16111,14256,11248,25994,31160,29997,13921,13096,18385,7935,3352,38.9,160071,153001,37084,29672,160071,76650,83421,29672,13150,16522
0500000US01121,"Talladega County, Alabama",80103,39813,40290,4178,6047,4174,5330,4241,9874,10184,11026,6043,5209,8319,4011,1467,40.8,62524,59621,17273,13797,62524,29767,32757,13797,6155,7642
0500000US01125,"Tuscaloosa County, Alabama",206102,99017,107085,12376,12019,11870,17624,24216,31080,24939,22962,11752,11873,15511,6241,3639,32.9,162735,147768,32770,25391,162735,77059,85676,25391,10794,14597
0500000US01127,"Walker County, Alabama",64967,32091,32876,3958,4205,3470,4217,3670,7778,7530,8769,4952,3930,7444,3711,1333,41.8,50572,48516,14712,12488,50572,24123,26449,12488,5327,7161
0500000US02020,"Anchorage Municipality, Alaska",298192,152882,145310,21661,20655,19468,19412,23467,52809,39268,36160,19589,16618,19287,6652,3146,33,224224,213118,38691,29085,224224,114143,110081,29085,13595,15490
0500000US02090,"Fairbanks North Star Borough, Alaska",100605,55651,44954,7185,7662,6343,6410,11896,17886,11544,11327,6733,5013,6170,1999,437,30.6,76096,70981,11067,8606,76096,42328,33768,8606,4388,4218
0500000US02170,"Matanuska-Susitna Borough, Alaska",104365,54259,50106,7301,7958,8380,7372,7155,14812,13397,13455,8069,5803,7382,2484,797,34.2,75994,72496,13967,10663,75994,39571,36423,10663,5337,5326
0500000US04001,"Apache County, Arizona",73112,35514,37598,4860,5747,6483,6335,4507,8994,8398,8546,4035,4574,6498,3139,996,34.6,52162,48377,12522,10633,52162,25596,26566,10633,4976,5657
0500000US04003,"Cochise County, Arizona",125770,63326,62444,7557,8255,7328,7740,7052,16154,13584,14883,6754,9911,15466,8457,2629,40.8,97976,93286,32806,26552,97976,49647,48329,26552,12614,13938
0500000US04005,"Coconino County, Arizona",140908,70483,70425,7624,7568,8614,17372,17864,17194,15174,15893,9026,7932,10498,4266,1883,30.9,111864,94670,21267,16647,111864,55340,56524,16647,7896,8751
0500000US04013,"Maricopa County, Arizona",4242997,2097936,2145061,281761,288903,292454,289116,283922,608882,552398,543539,248578,233515,362189,185429,72311,36.2,3202882,3034378,754123,619929,3202882,1566693,1636189,619929,279340,340589
0500000US04015,"Mohave County, Arizona",205249,103278,101971,8957,10546,10456,11038,8980,21037,18042,24481,16295,16476,34795,17608,6538,50.6,168384,162605,69233,58941,168384,84431,83953,58941,29319,29622
0500000US04017,"Navajo County, Arizona",110026,55099,54927,7792,8794,8458,8186,6037,14279,11511,12347,7231,7061,11143,5611,1576,36.3,79312,75388,21644,18330,79312,39528,39784,18330,8599,9731
0500000US04019,"Pima County, Arizona",1016206,499791,516415,59029,60807,59594,69655,90201,125100,113791,115628,61688,66979,110989,60334,22411,38.3,798539,746088,233282,193734,798539,388711,409828,193734,87822,105912
0500000US04021,"Pinal County, Arizona",418540,217387,201153,24446,29550,27845,25962,23018,53102,55455,46625,25932,23195,52074,25343,5993,39.2,320300,307208,98009,83410,320300,167581,152719,83410,40513,42897
0500000US04025,"Yavapai County, Arizona",225562,110885,114677,8356,11747,10526,13227,9437,19565,19362,26041,16804,23117,40051,20373,6956,53.1,188282,177494,81352,67380,188282,91160,97122,67380,32612,34768
0500000US04027,"Yuma County, Arizona",205631,106203,99428,14916,15975,13007,14426,17572,27534,22430,21716,9736,10323,19458,15180,3358,34.8,153248,144684,44135,37996,153248,79264,73984,37996,18161,19835
0500000US05007,"Benton County, Arkansas",258291,128175,130116,18576,19769,19940,17336,14161,37940,36806,32737,14913,12523,19986,9535,4069,35.4,189085,179822,40360,33590,189085,92643,96442,33590,15226,18364
0500000US05031,"Craighead County, Arkansas",105835,52521,53314,6873,8634,6007,9908,6892,15318,13812,12197,6362,5374,8544,4038,1876,34.5,79739,73191,17880,14458,79739,39001,40738,14458,5963,8495
0500000US05045,"Faulkner County, Arkansas",122227,59273,62954,7436,7790,8656,10159,13510,17224,15527,14504,6829,5927,8892,4009,1764,33.1,93857,85702,18151,14665,93857,44826,49031,14665,6428,8237
0500000US05051,"Garland County, Arkansas",97477,47024,50453,5483,7189,4339,6045,4995,10783,10940,12008,8664,5544,12163,6539,2785,44,77082,73223,25261,21487,77082,36461,40621,21487,9849,11638
0500000US05069,"Jefferson County, Arkansas",70016,34819,35197,4215,3566,5202,4896,5349,8113,8505,8942,5227,4614,6651,3231,1505,39,54176,51116,13621,11387,54176,26459,27717,11387,4978,6409
0500000US05085,"Lonoke County, Arkansas",72228,35917,36311,4742,4413,5581,5077,4390,10190,9399,9691,4380,4388,6078,3120,779,36.4,53793,52083,12467,9977,53793,26205,27588,9977,4358,5619
0500000US05119,"Pulaski County, Arkansas",393250,188529,204721,26098,29456,22239,24578,25771,57408,48680,51115,25485,25869,33820,16174,6557,36.8,300615,285925,72061,56551,300615,140966,159649,56551,23844,32707
0500000US05125,"Saline County, Arkansas",118703,59231,59472,7177,7790,8102,7946,5911,15477,14927,15877,7294,7336,12278,7429,1159,41,90878,86043,25966,20866,90878,44626,46252,20866,9471,11395
0500000US05131,"Sebastian County, Arkansas",127793,61949,65844,8060,9070,8164,8854,7520,17553,16070,16922,9163,6923,11923,5223,2348,37.8,96840,91214,23241,19494,96840,46455,50385,19494,8472,11022
0500000US05143,"Washington County, Arkansas",228049,113146,114903,15401,15084,16757,19082,25027,33502,28949,25758,11125,10875,15799,7669,3021,31.5,171815,156265,33194,26489,171815,84797,87018,26489,11801,14688
0500000US05145,"White County, Arkansas",79263,38113,41150,5457,4743,5435,6469,5853,10489,9352,10145,4687,4252,7165,3729,1487,35.8,60509,54266,14207,12381,60509,28710,31799,12381,5401,6980
0500000US06001,"Alameda County, California",1647704,809120,838584,97792,97766,94636,94677,103650,272967,243462,226475,107374,93487,127375,58931,29112,37.4,1302218,1243171,268980,215418,1302218,632053,670165,215418,93967,121451
0500000US06007,"Butte County, California",226864,111727,115137,11488,14552,12159,15984,24925,27079,23961,26551,15335,13774,23892,11582,5582,38.1,181186,166501,49286,41056,181186,87866,93320,41056,18209,22847
0500000US06013,"Contra Costa County, California",1135127,554517,580610,66024,73469,75758,72307,68400,144333,151293,165527,78053,70123,99205,48402,22233,39.5,873571,834018,211128,169840,873571,421511,452060,169840,74338,95502
0500000US06017,"El Dorado County, California",185625,93447,92178,8523,11750,9976,11860,9247,17660,21081,27621,17435,14843,22049,8337,5243,46.1,147684,141392,45232,35629,147684,73181,74503,35629,17170,18459
0500000US06019,"Fresno County, California",979915,489186,490729,78927,78038,78810,71944,73215,148909,119815,112412,55294,46457,67743,32129,16222,32.1,699456,655969,140121,116094,699456,346062,353394,116094,51848,64246
0500000US06023,"Humboldt County, California",136646,67540,69106,6819,7141,8158,9112,13704,17593,17010,15368,9896,8894,14848,5414,2689,37.9,110070,103955,27811,22951,110070,54541,55529,22951,10586,12365
0500000US06025,"Imperial County, California",180883,92611,88272,14948,13917,14166,14376,14055,26063,21409,20350,9411,9055,12720,7150,3263,32.5,129129,121110,28225,23133,129129,65786,63343,23133,10203,12930
0500000US06029,"Kern County, California",884788,454117,430671,70930,73086,72557,65852,69498,136121,110617,102432,51373,40749,55641,25234,10698,31.3,626589,589264,116015,91573,626589,322624,303965,91573,41573,50000
0500000US06031,"Kings County, California",149785,82378,67407,11702,10298,12711,9868,13125,24398,19366,19731,7708,6503,8027,4712,1636,31.8,108847,102231,17873,14375,108847,61837,47010,14375,6451,7924
0500000US06033,"Lake County, California",64116,31258,32858,3369,3971,3869,3450,1847,6166,8149,7866,5805,4491,9278,3905,1950,46.5,50829,49230,17817,15133,50829,24813,26016,15133,7303,7830
0500000US06037,"Los Angeles County, California",10137915,4994405,5143510,628305,621873,614183,655202,740323,1613327,1383874,1383893,639266,549096,742236,388753,177584,36.3,7884800,7467576,1614775,1308573,7884800,3842514,4042286,1308573,565210,743363
0500000US06039,"Madera County, California",154697,74406,80291,11213,12756,11754,11264,11706,21397,18625,18155,9580,7788,12803,5593,2063,33.6,112155,106124,24868,20459,112155,53072,59083,20459,9958,10501
0500000US06041,"Marin County, California",260651,126528,134123,12754,14852,16410,14597,11813,21624,33876,40903,20643,19333,31949,14337,7560,46.1,207491,200048,65291,53846,207491,100008,107483,53846,23764,30082
0500000US06045,"Mendocino County, California",87628,42946,44682,5326,5195,5659,5777,3747,10321,9764,10697,6018,7643,11028,4463,1990,42.8,68310,64599,21668,17481,68310,33691,34619,17481,7961,9520
0500000US06047,"Merced County, California",268672,135524,133148,21688,23215,21878,22677,21168,38805,32870,30404,13594,13390,16716,8213,4054,30.9,188400,174315,35813,28983,188400,94316,94084,28983,13333,15650
0500000US06053,"Monterey County, California",435232,222251,212981,32659,32390,31972,30956,31812,63220,56134,52396,24752,23700,32034,15192,8015,34,320446,299943,67829,55241,320446,162889,157557,55241,24940,30301
0500000US06055,"Napa County, California",142166,70550,71616,7366,8382,8947,8527,9792,17179,17715,19106,10056,9309,14432,7820,3535,41,112071,107142,31672,25787,112071,55303,56768,25787,11893,13894
0500000US06057,"Nevada County, California",99107,50350,48757,3698,4658,6245,4623,4159,10611,10027,11785,8358,9275,15720,6458,3490,50.2,81380,79549,31588,25668,81380,40278,41102,25668,12336,13332
0500000US06059,"Orange County, California",3172532,1565562,1606970,188873,188948,207586,208807,218622,453741,413720,458469,208077,182491,250608,129954,62636,37.7,2459891,2334135,546881,443198,2459891,1201523,1258368,443198,196034,247164
0500000US06061,"Placer County, California",380531,185096,195435,20112,24449,25107,25257,18957,41749,48228,53206,26648,24667,41508,20554,10089,41.9,295157,281456,86013,72151,295157,141805,153352,72151,31768,40383
0500000US06065,"Riverside County, California",2387741,1187627,1200114,157515,172565,174906,177388,170753,329408,301969,305302,145226,121151,188926,101433,41199,35.3,1773804,1666247,400091,331558,1773804,875230,898574,331558,151015,180543
0500000US06067,"Sacramento County, California",1514460,739516,774944,99302,96872,106691,94613,99257,235323,196255,195880,95707,88318,119931,58376,27935,36,1151402,1099563,257062,206242,1151402,554612,596790,206242,89296,116946
0500000US06071,"San Bernardino County, California",2140096,1063881,1076215,153924,159434,161232,160169,168366,318466,272885,270029,128263,110242,144675,65231,27180,33.2,1566789,1469013,294624,237086,1566789,771666,795123,237086,106553,130533
0500000US06073,"San Diego County, California",3317749,1667581,1650168,213615,197443,198933,209016,263014,544022,434359,423016,203802,184706,255604,125802,64417,35.7,2589421,2446052,551693,445823,2589421,1295376,1294045,445823,197245,248578
0500000US06075,"San Francisco County, California",870887,443777,427110,39668,33176,27943,30893,49511,203463,137227,117988,50841,50840,70829,36640,21868,38,752912,731561,159211,129337,752912,383821,369091,129337,57885,71452
0500000US06077,"San Joaquin County, California",733709,365605,368104,51927,59475,55170,55336,51240,101966,93623,92936,42697,38486,53871,26242,10740,34.3,532349,502291,111683,90853,532349,262439,269910,90853,39994,50859
0500000US06079,"San Luis Obispo County, California",282887,142925,139962,13119,13724,15253,22694,29347,32508,30078,32864,19155,19991,32641,14816,6697,38.8,232194,208639,66150,54154,232194,117344,114850,54154,25205,28949
0500000US06081,"San Mateo County, California",764797,377751,387046,43758,45463,46204,40512,41544,111731,109407,110073,51834,48035,65476,33193,17567,39.5,603272,583058,143354,116236,603272,294495,308777,116236,50741,65495
0500000US06083,"Santa Barbara County, California",446170,223041,223129,28952,29155,25600,36925,49569,59548,50648,49971,25759,24813,35871,20194,9165,33.8,346046,313899,79355,65230,346046,172104,173942,65230,29084,36146
0500000US06085,"Santa Clara County, California",1919402,968824,950578,118094,123546,121337,113892,121514,303241,278434,270955,120574,102272,138336,72626,34581,37,1486224,1419419,301540,245543,1486224,746641,739583,245543,109112,136431
0500000US06087,"Santa Cruz County, California",274673,136118,138555,14508,15219,15028,23454,27423,31610,32347,36188,19583,18467,25482,11363,4001,37.4,220517,197715,51492,40846,220517,108152,112365,40846,18630,22216
0500000US06089,"Shasta County, California",179631,88646,90985,10614,10183,11232,10952,10442,21921,19101,22076,12618,13999,21469,11739,3285,42.1,141017,134382,44633,36493,141017,68258,72759,36493,16635,19858
0500000US06095,"Solano County, California",440207,219221,220986,27370,27436,27447,26647,30414,64381,53652,58594,30888,28782,39216,17190,8190,37.9,341301,325878,82679,64596,341301,168351,172950,64596,28668,35928
0500000US06097,"Sonoma County, California",503070,245647,257423,25519,27938,29985,29185,29991,65058,62392,67519,33722,39666,56376,23536,12183,42.1,402387,384239,116211,92095,402387,194508,207879,92095,40688,51407
0500000US06099,"Stanislaus County, California",541560,266537,275023,39596,39690,43457,39162,37139,78543,67064,66942,32213,28591,40271,20977,7915,34,394444,372444,85596,69163,394444,192607,201837,69163,30553,38610
0500000US06101,"Sutter County, California",96651,48681,47970,6560,6937,7487,6964,6830,11893,12302,11724,5324,6131,7520,4838,2141,35.9,71696,67736,17868,14499,71696,35284,36412,14499,6714,7785
0500000US06107,"Tulare County, California",460437,228947,231490,39388,40402,40838,36634,33637,64708,57068,52104,24847,20617,29544,14927,5723,30.8,316467,294995,61423,50194,316467,156273,160194,50194,22745,27449
0500000US06111,"Ventura County, California",849738,420103,429635,51863,55659,57197,57671,59796,112032,105191,116712,57367,52520,72047,34843,16840,37.7,649288,613756,153695,123730,649288,318653,330635,123730,55269,68461
0500000US06113,"Yolo County, California",215802,105035,110767,12474,13911,11687,20195,29864,29809,26118,23047,11995,10776,15163,6971,3792,30.9,170122,150482,33025,25926,170122,82057,88065,25926,11561,14365
0500000US06115,"Yuba County, California",75275,37967,37308,5695,6567,5730,4769,5527,12259,8833,8703,4462,4587,5189,1788,1166,32.4,54308,51816,10835,8143,54308,27227,27081,8143,4121,4022
0500000US08001,"Adams County, Colorado",498187,250881,247306,36564,37468,40133,33584,32361,79882,71775,63579,30553,22507,31252,13385,5144,33.7,362191,343539,61876,49781,362191,181753,180438,49781,22612,27169
0500000US08005,"Arapahoe County, Colorado",637068,316007,321061,40915,43660,43062,38883,41089,97034,89412,84736,43571,34994,49374,21451,8887,36.5,483952,464357,100465,79712,483952,236152,247800,79712,35213,44499
0500000US08013,"Boulder County, Colorado",322226,161728,160498,15551,16889,19712,25894,33593,43246,40939,42411,22066,19042,26546,12080,4257,36.4,258786,236235,54228,42883,258786,129364,129422,42883,19517,23366
0500000US08014,"Broomfield County, Colorado",66529,32659,33870,3792,3985,4903,3683,4807,9524,9564,9956,3691,4058,5327,2119,1120,38.4,50862,49752,10884,8566,50862,25016,25846,8566,3725,4841
0500000US08031,"Denver County, Colorado",693060,347500,345560,44071,42153,35330,34100,42759,156779,108276,81294,36251,34632,46892,20697,9826,34.4,552420,529862,98691,77415,552420,276028,276392,77415,33767,43648
0500000US08035,"Douglas County, Colorado",328632,164070,164562,19466,25144,27822,24636,15803,34825,50509,54137,22322,17884,23303,9844,2937,38.9,239226,228790,46797,36084,239226,117809,121417,36084,16814,19270
0500000US08041,"El Paso County, Colorado",688284,348155,340129,47480,47377,46062,47467,58127,107430,85319,84733,46703,34155,52295,22507,8629,33.9,519253,488921,101170,83431,519253,260964,258289,83431,37135,46296
0500000US08059,"Jefferson County, Colorado",571837,284185,287652,30159,32597,32469,33779,33750,81348,74391,80025,43950,40009,54295,25457,9608,40.2,455903,435433,112053,89360,455903,224961,230942,89360,40129,49231
0500000US08069,"Larimer County, Colorado",339993,170498,169495,17756,18384,20397,24087,37324,48148,40973,39599,22166,21006,31285,12563,6305,35.9,271967,250803,62697,50153,271967,135065,136902,50153,23088,27065
0500000US08077,"Mesa County, Colorado",150083,74153,75930,9427,10564,8242,10433,10745,17723,17887,17481,10426,10205,15472,7907,3571,39.8,116297,108504,33474,26950,116297,56501,59796,26950,12269,14681
0500000US08101,"Pueblo County, Colorado",165123,81828,83295,9803,11261,10231,9721,11905,20976,19603,20035,11146,10953,16951,9060,3478,39.1,127304,121312,35710,29489,127304,62541,64763,29489,13470,16019
0500000US08123,"Weld County, Colorado",294932,148543,146389,21575,24513,19835,21572,19277,43063,39319,36700,19228,15402,21710,9125,3613,34.3,216615,202569,42789,34448,216615,108187,108428,34448,16277,18171
0500000US09001,"Fairfield County, Connecticut",944177,459940,484237,52695,60858,63107,67962,60087,108109,118652,144468,68714,59750,76476,41858,21441,40.4,726508,687852,171693,139775,726508,348640,377868,139775,60031,79744
0500000US09003,"Hartford County, Connecticut",892389,433714,458675,47927,49552,57390,59758,57927,117223,108062,126871,65130,57717,80303,40019,24510,40.6,702007,668706,176444,144832,702007,336342,365665,144832,61329,83503
0500000US09005,"Litchfield County, Connecticut",182571,90394,92177,7496,8153,11447,10700,9984,17750,20340,29167,16151,14936,21233,9590,5624,46.8,148318,143218,44765,36447,148318,72233,76085,36447,16475,19972
0500000US09007,"Middlesex County, Connecticut",163329,80205,83124,6861,7258,10103,10038,11151,16802,17848,26252,14038,12371,17309,8169,5129,45.6,133136,126179,37265,30607,133136,64215,68921,30607,13470,17137
0500000US09009,"New Haven County, Connecticut",856875,413588,443287,44645,46568,52098,59917,60565,114097,100218,120954,62016,56463,78138,40587,20609,39.9,680293,641157,171483,139334,680293,323202,357091,139334,59232,80102
0500000US09011,"New London County, Connecticut",269801,134326,135475,13840,14179,15704,18119,20337,33029,31456,38286,20376,19146,26418,12143,6768,41.5,216196,203439,55808,45329,216196,107458,108738,45329,20000,25329
0500000US09013,"Tolland County, Connecticut",151118,75753,75365,5848,8143,7584,14677,20439,14951,14416,21599,10364,10766,13163,6720,2448,37.7,124515,108689,28519,22331,124515,62223,62292,22331,10326,12005
0500000US09015,"Windham County, Connecticut",116192,57233,58959,5717,6177,6577,8144,8983,14635,13500,17132,8671,8671,10595,5224,2166,40.8,93317,87626,22412,17985,93317,46077,47240,17985,7981,10004
0500000US10001,"Kent County, Delaware",174827,83893,90934,11174,11402,10938,12612,11980,24759,19849,21725,11952,9498,17216,9040,2682,37.5,134296,126508,34133,28938,134296,63148,71148,28938,12432,16506
0500000US10003,"New Castle County, Delaware",556987,269580,287407,32547,31558,36609,38040,36325,80958,68205,77719,38959,34917,47775,22934,10441,38.5,435136,411422,102030,81150,435136,208027,227109,81150,35112,46038
0500000US10005,"Sussex County, Delaware",220251,106759,113492,11520,11756,11728,10182,11147,22852,21964,26419,18903,17194,35299,16220,5067,48.7,178396,172535,68423,56586,178396,85507,92889,56586,26385,30201
0500000US11001,"District of Columbia, District of Columbia",681170,323591,357579,43546,34709,26875,37591,58291,154662,98911,77605,35336,34547,46167,22588,10342,33.9,560388,527007,99961,79097,560388,262728,297660,79097,32467,46630
0500000US12001,"Alachua County, Florida",263496,126827,136669,14399,14484,11171,24456,39419,40611,27453,26912,15222,14982,20397,8475,5515,31.3,215724,188988,42654,34387,215724,103059,112665,34387,15093,19294
0500000US12005,"Bay County, Florida",183974,91650,92324,11338,12611,9070,10852,11409,25253,22037,25577,14337,10667,18070,10161,2592,40.1,144014,137968,37171,30823,144014,71166,72848,30823,14280,16543
0500000US12009,"Brevard County, Florida",579130,281982,297148,27530,29038,31049,29905,32218,64314,58300,79338,49262,43996,72396,45541,16243,47.3,471961,455655,159887,134180,471961,227365,244596,134180,61000,73180
0500000US12011,"Broward County, Florida",1909632,929377,980255,111347,106869,117516,112521,113058,259466,252541,279034,134652,115387,170683,89649,46909,40.3,1502273,1439967,374491,307241,1502273,722533,779740,307241,134525,172716
0500000US12015,"Charlotte County, Florida",178465,87345,91120,5459,6457,6119,7705,7318,13182,12780,19410,16227,14371,38301,21898,9238,58.5,155660,151176,77784,69437,155660,75328,80332,69437,33349,36088
0500000US12017,"Citrus County, Florida",143621,69132,74489,5356,5552,5559,6502,5026,11833,11921,16326,13229,11487,27496,15917,7417,56.4,123355,120189,58369,50830,123355,58483,64872,50830,24216,26614
0500000US12019,"Clay County, Florida",208311,101957,106354,11646,14729,13275,15081,11837,24742,27530,30298,14676,13275,19557,8713,2952,40.4,158910,151601,38149,31222,158910,76931,81979,31222,14098,17124
0500000US12021,"Collier County, Florida",365136,178667,186469,16429,18869,17680,19166,17268,35066,36645,42110,22132,26799,59577,38064,15331,50.3,301170,290189,129375,112972,301170,146132,155038,112972,53341,59631
0500000US12023,"Columbia County, Florida",69299,36080,33219,3942,4856,3454,4781,4901,8425,7686,9407,3999,5268,7287,3448,1845,41.2,54538,50997,15838,12580,54538,28624,25914,12580,5867,6713
0500000US12031,"Duval County, Florida",926255,448891,477364,62668,58334,56041,53930,63577,152526,116254,120875,61634,55362,75927,33020,16107,36.1,716496,684479,157325,125054,716496,342192,374304,125054,53560,71494
0500000US12033,"Escambia County, Florida",315187,156201,158986,19209,16709,19238,23538,26001,44275,35255,37362,22705,19294,30279,15970,5352,37.3,249320,231127,63891,51601,249320,123064,126256,51601,22540,29061
0500000US12035,"Flagler County, Florida",108310,52422,55888,4032,4387,6121,7004,4620,9899,9773,13405,7703,8110,18674,10865,3717,51.1,89485,85248,37996,33256,89485,42467,47018,33256,15625,17631
0500000US12053,"Hernando County, Florida",182835,87602,95233,7753,9404,10208,10535,8061,19087,17445,23531,14218,12041,27580,16850,6122,49,148668,143409,58029,50552,148668,70301,78367,50552,23666,26886
0500000US12055,"Highlands County, Florida",100917,47825,53092,4371,6121,4322,5697,3454,9250,8259,11010,7257,6813,17330,12840,4193,54.4,83236,79879,37969,34363,83236,39956,43280,34363,15914,18449
0500000US12057,"Hillsborough County, Florida",1376238,670193,706045,88039,88802,86578,88170,89979,208933,185452,187704,86019,78024,111191,55506,21841,37,1059468,1004599,231513,188538,1059468,508358,551110,188538,82860,105678
0500000US12061,"Indian River County, Florida",151563,72644,78919,5323,4899,8683,12014,7713,12160,11665,18649,8514,13467,25847,15594,7035,53,126717,119256,55337,48476,126717,60103,66614,48476,22182,26294
0500000US12069,"Lake County, Florida",335396,163604,171792,16810,16514,20072,18324,17569,34726,36117,41859,21882,22496,49809,29674,9544,46.7,269996,260331,103639,89027,269996,129009,140987,89027,40992,48035
0500000US12071,"Lee County, Florida",722336,354048,368288,34374,32780,41107,37510,35951,78301,74705,87701,46992,54959,112712,60622,24622,48.2,590986,570964,230647,197956,590986,286676,304310,197956,94493,103463
0500000US12073,"Leon County, Florida",287822,136318,151504,14858,13947,15558,25580,47562,41685,31294,29768,15617,16021,22639,9561,3732,30.8,234258,205816,45386,35932,234258,109112,125146,35932,15686,20246
0500000US12081,"Manatee County, Florida",375888,181270,194618,18702,21403,18529,20530,18872,37399,39250,47801,26327,27818,55500,30743,13014,47.7,304705,292206,115048,99257,304705,145492,159213,99257,45921,53336
0500000US12083,"Marion County, Florida",349020,168449,180571,17196,17511,20106,17702,16403,38061,32505,41889,25703,22319,55384,32169,12072,48.6,283739,273837,113640,99625,283739,134200,149539,99625,46427,53198
0500000US12085,"Martin County, Florida",158701,78291,80410,7147,7011,8133,9549,6062,14224,14464,20216,11614,12391,23968,15518,8404,51.5,131743,125994,55257,47890,131743,64472,67271,47890,21948,25942
0500000US12086,"Miami-Dade County, Florida",2712945,1315759,1397186,157487,152984,148032,155696,172329,390085,375803,401531,179297,146620,231558,136939,64584,39.9,2160739,2061329,518440,433081,2160739,1034316,1126423,433081,179882,253199
0500000US12087,"Monroe County, Florida",79077,41660,37417,3993,2830,3156,3940,5179,8733,9623,11659,6664,6091,10946,4397,1866,46.3,67239,64030,20774,17209,67239,35425,31814,17209,9268,7941
0500000US12089,"Nassau County, Florida",80622,38905,41717,3803,4273,4899,4575,3358,9223,9867,10537,5830,6929,11091,4084,2153,45.2,64742,62319,22220,17328,64742,30619,34123,17328,8242,9086
0500000US12091,"Okaloosa County, Florida",201170,102605,98565,13561,11365,12468,11561,14916,31025,23155,25009,14179,12364,17897,10621,3049,37.2,156859,149403,38784,31567,156859,79542,77317,31567,14079,17488
0500000US12095,"Orange County, Florida",1314367,646317,668050,82700,80431,82447,87916,105781,220809,184048,176506,79107,67183,88981,41494,16964,34.9,1018566,957072,187357,147439,1018566,495145,523421,147439,64252,83187
0500000US12097,"Osceola County, Florida",336015,163661,172354,23236,21621,23179,24977,22122,50249,45672,44251,21276,15546,26854,12141,4891,35.6,253015,239623,53919,43886,253015,123150,129865,43886,19658,24228
0500000US12099,"Palm Beach County, Florida",1443810,698414,745396,74578,77010,78260,81177,78655,172561,164543,192388,99164,89123,165424,111380,59547,44.7,1164085,1117813,386455,336351,1164085,555328,608757,336351,147580,188771
0500000US12101,"Pasco County, Florida",512368,249613,262755,26655,27916,30582,29445,25338,55456,61890,69941,35035,33168,65664,38471,12807,44.8,408478,391052,138508,116942,408478,196584,211894,116942,53717,63225
0500000US12103,"Pinellas County, Florida",960730,460325,500405,43321,41683,46504,45424,48237,114255,104393,135903,74532,77415,123593,70173,35297,48,800553,775189,276258,229063,800553,379030,421523,229063,101278,127785
0500000US12105,"Polk County, Florida",666149,325981,340168,39000,44005,40648,41893,39520,85549,77580,82087,42045,40336,76851,42651,13984,40.2,516653,492016,157170,133486,516653,249810,266843,133486,61258,72228
0500000US12107,"Putnam County, Florida",72277,36698,35579,3488,4433,4857,3995,4452,7238,7442,9326,5695,5537,8882,5137,1795,45.3,56655,54496,19914,15814,56655,27625,29030,15814,7479,8335
0500000US12109,"St. Johns County, Florida",235087,115221,119866,11314,12862,17940,14969,11816,24369,29795,34279,17009,16499,27683,11448,5104,43,182854,175140,53425,44235,182854,87537,95317,44235,20541,23694
0500000US12111,"St. Lucie County, Florida",306507,148782,157725,15667,17479,17653,18314,18562,30381,34419,39217,22706,19909,38893,22560,10747,45.2,244455,233761,83611,72200,244455,117089,127366,72200,33597,38603
0500000US12113,"Santa Rosa County, Florida",170497,86775,83722,10153,9584,11520,10833,8445,23313,21774,25982,13407,9679,16101,7315,2391,40.3,132551,127346,32007,25807,132551,67911,64640,25807,12217,13590
0500000US12115,"Sarasota County, Florida",412569,197570,214999,13827,16052,19369,18715,16103,33613,35699,49148,30933,33387,75671,46808,23244,55.5,352685,340474,167384,145723,352685,165813,186872,145723,66424,79299
0500000US12117,"Seminole County, Florida",455479,219626,235853,23837,28798,25550,28683,28109,65714,61062,65138,29639,29804,40676,20182,8287,39.2,358762,342393,86054,69145,358762,170306,188456,69145,29750,39395
0500000US12119,"Sumter County, Florida",123996,61477,62519,2066,1614,3318,3882,4388,6136,7233,7370,9287,8879,43075,22328,4420,67.3,115231,112273,75955,69823,115231,57316,57915,69823,33767,36056
0500000US12127,"Volusia County, Florida",529364,258972,270392,24319,27441,24260,29974,31334,60095,55345,68553,41343,39749,71136,40502,15313,46.8,435026,415632,149437,126951,435026,209854,225172,126951,57695,69256
0500000US12131,"Walton County, Florida",65889,34195,31694,3098,1949,5060,4121,3849,7119,7827,9144,5600,5151,8437,3064,1470,44.9,52961,50924,15375,12971,52961,27030,25931,12971,6308,6663
0500000US13013,"Barrow County, Georgia",77126,37956,39170,4864,6263,6155,5046,4199,11421,11339,10327,4987,3626,5956,2260,683,35.5,56601,54313,10886,8899,56601,27392,29209,8899,4081,4818
0500000US13015,"Bartow County, Georgia",103807,51468,52339,6797,8435,6840,6006,5947,14162,14433,14470,7396,5598,8683,3969,1071,37.2,77955,74542,16538,13723,77955,37563,40392,13723,6298,7425
0500000US13021,"Bibb County, Georgia",152760,71693,81067,10852,10394,10567,10952,10934,21062,17294,18799,9426,10010,13272,6303,2895,36.1,114601,106792,28659,22470,114601,52077,62524,22470,8960,13510
0500000US13031,"Bulloch County, Georgia",74722,37678,37044,4365,3701,4290,11101,10159,9771,8360,7561,3920,3253,4825,2612,804,28.4,60078,48673,9954,8241,60078,29622,30456,8241,3854,4387
0500000US13045,"Carroll County, Georgia",116261,57902,58359,6861,6718,8903,10904,10277,15114,14676,13954,6572,7173,9495,4039,1575,34.1,88252,80878,19347,15109,88252,42779,45473,15109,6650,8459
0500000US13047,"Catoosa County, Georgia",66398,32948,33450,4049,3622,4624,3824,3910,8373,9023,9050,4401,4147,6995,3628,752,40,51213,50102,13925,11375,51213,24052,27161,11375,4843,6532
0500000US13051,"Chatham County, Georgia",289082,139200,149882,19084,18592,16223,19381,22676,47222,35780,34109,18894,15317,25015,11386,5403,35.3,225667,211990,50701,41804,225667,106795,118872,41804,17949,23855
0500000US13057,"Cherokee County, Georgia",241689,119033,122656,14593,16998,18639,16323,13379,28045,35241,37766,15176,14185,20723,7915,2706,38.7,180535,173290,39764,31344,180535,86530,94005,31344,13383,17961
0500000US13059,"Clarke County, Georgia",124707,60024,64683,7910,5940,5217,12985,24114,21363,12079,11665,5468,5524,7668,3770,1004,27.5,103416,86712,15631,12442,103416,47904,55512,12442,5000,7442
0500000US13063,"Clayton County, Georgia",279462,128772,150690,22579,22591,21554,20118,19927,42679,37739,37100,15200,14864,17330,5872,1909,32.7,200429,188147,33251,25111,200429,91348,109081,25111,10624,14487
0500000US13067,"Cobb County, Georgia",748150,361331,386819,48078,51805,50196,51026,48739,107531,107228,108559,49712,39626,54451,22757,8442,36.5,566642,537365,110764,85650,566642,269896,296746,85650,37223,48427
0500000US13073,"Columbia County, Georgia",147450,71884,75566,9634,11095,10361,10341,9188,20134,21239,19512,7360,9987,11354,4908,2337,36.2,109212,103494,24459,18599,109212,52667,56545,18599,8508,10091
0500000US13077,"Coweta County, Georgia",140526,68236,72290,8848,9167,11451,9504,8078,17528,18875,21240,9841,8305,11019,5448,1222,39,105096,99708,22062,17689,105096,50033,55063,17689,7699,9990
0500000US13089,"DeKalb County, Georgia",740321,350328,389993,53628,49994,45460,42217,49216,124232,106730,99856,46189,40510,52192,21779,8318,35.4,564723,537598,106164,82289,564723,261579,303144,82289,33555,48734
0500000US13095,"Dougherty County, Georgia",90017,40903,49114,6022,4742,7809,6246,7949,12009,11267,9482,5758,5799,7569,3986,1379,35.2,67559,63480,16676,12934,67559,29922,37637,12934,5290,7644
0500000US13097,"Douglas County, Georgia",142224,68772,73452,8699,11032,10783,9989,10005,18274,18946,22215,8370,7987,11296,3917,711,36,105036,98993,20412,15924,105036,49281,55755,15924,7128,8796
0500000US13113,"Fayette County, Georgia",111627,53888,57739,4913,6527,8929,9031,5886,10437,12845,17292,9659,6750,12216,4904,2238,43.3,85604,80548,22387,19358,85604,40612,44992,19358,8678,10680
0500000US13115,"Floyd County, Georgia",96560,47010,49550,5280,5082,7410,7815,7191,11725,12303,12276,6921,5000,9056,5042,1459,38.7,74125,69868,18304,15557,74125,35206,38919,15557,6794,8763
0500000US13117,"Forsyth County, Georgia",221009,109708,111301,13565,17054,20185,16050,11356,20465,35920,36991,12925,9840,16690,7410,2558,38.7,158991,151469,32071,26658,158991,77761,81230,26658,11902,14756
0500000US13121,"Fulton County, Georgia",1023336,495020,528316,63312,64360,64481,69053,74393,168838,148098,144027,64603,48858,69420,30855,13038,35.4,791710,747514,139497,113313,791710,377883,413827,113313,47210,66103
0500000US13127,"Glynn County, Georgia",84502,39690,44812,4917,6402,4988,5223,4788,10792,8506,12043,6877,4742,9248,4438,1538,41,65060,61680,18361,15224,65060,29857,35203,15224,6636,8588
0500000US13135,"Gwinnett County, Georgia",907135,443379,463756,61078,66573,76760,67898,59745,119222,134241,136033,57091,43791,54636,22708,7359,35.2,657829,623154,107504,84703,657829,316597,341232,84703,36838,47865
0500000US13139,"Hall County, Georgia",196637,97493,99144,13247,14260,14775,14085,12873,24652,25742,27059,10810,10995,17166,8902,2071,36.5,145552,138093,34385,28139,145552,71335,74217,28139,12443,15696
0500000US13151,"Henry County, Georgia",221768,106026,115742,12561,15854,18233,17750,13773,28378,30511,34709,13882,12171,15691,6275,1980,36.5,163293,155266,30329,23946,163293,75678,87615,23946,10581,13365
0500000US13153,"Houston County, Georgia",152122,74525,77597,10332,11634,10670,10039,8671,23106,20657,19871,9272,8648,11192,5823,2207,35.4,112967,106430,22860,19222,112967,54359,58608,19222,8527,10695
0500000US13179,"Liberty County, Georgia",62570,32287,30283,6133,3872,5351,3876,7981,11165,7265,6019,2711,2927,3329,1519,422,27.2,44983,42244,6455,5270,44983,23105,21878,5270,2218,3052
0500000US13185,"Lowndes County, Georgia",114628,56100,58528,7922,8358,6768,8030,16084,17617,12975,12053,6140,5161,8064,3532,1924,30.5,87201,81207,16296,13520,87201,41974,45227,13520,5818,7702
0500000US13215,"Muscogee County, Georgia",197485,96919,100566,14638,13010,13621,14364,13981,32339,24685,22770,12490,10470,14360,7639,3118,33.7,148868,138901,31096,25117,148868,72264,76604,25117,10088,15029
0500000US13217,"Newton County, Georgia",106999,49949,57050,7378,8201,7984,9289,6986,11546,14411,15156,7381,5379,8292,2868,2128,36,78470,73034,16267,13288,78470,36528,41942,13288,5766,7522
0500000US13223,"Paulding County, Georgia",155825,75737,80088,9998,11083,13432,11541,11221,17815,23577,24637,8474,7192,11047,4794,1014,36.4,113791,107228,21303,16855,113791,54234,59557,16855,7467,9388
0500000US13245,"Richmond County, Georgia",201647,97382,104265,13800,14352,11328,13761,16817,33335,22988,23068,12162,13154,16287,7926,2669,34,154772,144630,34387,26882,154772,73641,81131,26882,10926,15956
0500000US13247,"Rockdale County, Georgia",89355,42098,47257,4988,6723,6223,7129,5509,9419,11906,13617,4877,6747,8211,2855,1151,38.4,66787,63814,15763,12217,66787,30704,36083,12217,5490,6727
0500000US13285,"Troup County, Georgia",70005,34260,35745,4597,4937,5112,4701,5243,9166,8510,9167,5164,3568,6237,2615,988,36.4,52480,49596,12062,9840,52480,24656,27824,9840,4163,5677
0500000US13295,"Walker County, Georgia",67896,34263,33633,4322,4124,4107,4681,2996,8225,8722,9550,5082,4210,7052,3595,1230,41.4,52588,49945,14089,11877,52588,25828,26760,11877,5194,6683
0500000US13297,"Walton County, Georgia",90184,44482,45702,5315,6339,6339,7838,6349,9568,11597,12601,6183,4612,8525,4029,889,38.3,67408,63400,16197,13443,67408,32548,34860,13443,5844,7599
0500000US13313,"Whitfield County, Georgia",104589,52233,52356,6760,8230,8101,8294,7511,13316,13415,13586,5874,5450,8432,3585,2035,35.1,76302,70755,17116,14052,76302,37678,38624,14052,6252,7800
0500000US15001,"Hawaii County, Hawaii",198449,98955,99494,12050,13072,10901,10440,12152,23298,23497,23725,13943,17412,23884,9077,4998,42.6,155670,150039,47914,37959,155670,76986,78684,37959,18579,19380
0500000US15003,"Honolulu County, Hawaii",992605,501898,490707,64210,56752,58616,53913,75048,153870,124187,122354,60453,58551,89500,47009,28142,37.5,780656,743710,200490,164651,780656,391945,388711,164651,72345,92306
0500000US15007,"Kauai County, Hawaii",72029,35051,36978,4538,5500,4065,3905,3593,7708,9621,9039,5065,5481,8424,3515,1575,42.3,55839,53588,16937,13514,55839,27563,28276,13514,6411,7103
0500000US15009,"Maui County, Hawaii",165379,82112,83267,9924,10979,9917,9793,8246,20957,22034,22507,12381,11245,17095,6587,3714,41.1,128532,122845,34324,27396,128532,62998,65534,27396,12703,14693
0500000US16001,"Ada County, Idaho",444028,222150,221878,26652,32173,30692,29394,27344,63825,60001,59579,26785,26253,38159,16600,6571,36.6,335696,317563,75728,61330,335696,166869,168827,61330,27976,33354
0500000US16005,"Bannock County, Idaho",84377,41577,42800,6290,6012,6250,6587,5946,11944,10917,8802,4493,5811,7087,2706,1532,34,61867,58108,15254,11325,61867,30448,31419,11325,5331,5994
0500000US16019,"Bonneville County, Idaho",112232,56459,55773,9307,10456,9579,8187,6540,15911,13702,11695,5177,6666,8943,3863,2206,33,77453,73145,19002,15012,77453,38219,39234,15012,7003,8009
0500000US16027,"Canyon County, Idaho",211698,104116,107582,16518,18458,16800,16642,13973,28186,26304,24114,12078,10486,17248,8034,2857,32.7,149482,140197,34757,28139,149482,72933,76549,28139,12978,15161
0500000US16055,"Kootenai County, Idaho",154311,76312,77999,9551,10359,9390,9530,9692,19496,18644,18689,10023,11237,16823,7949,2928,39.6,118910,112829,35985,27700,118910,57711,61199,27700,12796,14904
0500000US16083,"Twin Falls County, Idaho",83514,40607,42907,6363,6884,6385,5096,5827,11536,10201,9474,5554,3650,6821,3854,1869,34.7,60323,57886,14279,12544,60323,29139,31184,12544,5761,6783
0500000US17001,"Adams County, Illinois",66578,32707,33871,3902,4186,4455,3852,3716,7915,7818,8621,5380,3845,6868,3946,2074,42.1,51518,48974,14628,12888,51518,24801,26717,12888,5530,7358
0500000US17019,"Champaign County, Illinois",208419,103293,105126,11535,11687,9810,21265,33757,31316,22269,20234,10580,11428,13384,6745,4409,29.9,169245,146759,31086,24538,169245,84088,85157,24538,10892,13646
0500000US17031,"Cook County, Illinois",5203499,2526484,2677015,327051,319482,321365,318023,352707,847524,703176,670295,330689,307202,403538,206727,95720,36.5,4041780,3854920,877052,705985,4041780,1936355,2105425,705985,296243,409742
0500000US17037,"DeKalb County, Illinois",104528,52811,51717,5585,6275,6965,10085,14819,13871,12157,11197,7104,4448,6795,3357,1870,30.9,81698,71384,14782,12022,81698,40500,41198,12022,5395,6627
0500000US17043,"DuPage County, Illinois",929368,455769,473599,54531,62171,58231,61643,59862,117476,118953,133572,69279,60153,79045,35758,18694,39,715565,682805,167280,133497,715565,346925,368640,133497,58360,75137
0500000US17089,"Kane County, Illinois",531715,265152,266563,34311,36417,43350,39330,34129,63224,72696,76637,31741,32787,40385,18039,8669,37.2,391896,369614,87642,67093,391896,192843,199053,67093,29909,37184
0500000US17091,"Kankakee County, Illinois",110008,53865,56143,6475,7185,7811,7826,8332,12822,12722,15015,8806,5856,9681,5076,2401,38.2,84094,78354,20303,17158,84094,40500,43594,17158,7529,9629
0500000US17093,"Kendall County, Illinois",124695,61405,63290,8524,8798,12115,9699,7007,15668,20368,18092,6533,5088,7467,4138,1198,35.2,88851,83896,15454,12803,88851,42475,46376,12803,5096,7707
0500000US17097,"Lake County, Illinois",703047,351612,351435,41015,47266,52581,55598,51122,76763,88932,103722,50824,43231,55042,24800,12151,38.5,528854,495942,115332,91993,528854,262454,266400,91993,41358,50635
0500000US17099,"LaSalle County, Illinois",110642,55778,54864,5827,7038,6129,7488,6737,13334,12321,15084,8030,8475,10881,6113,3185,42.6,87053,82304,24817,20179,87053,43983,43070,20179,8955,11224
0500000US17111,"McHenry County, Illinois",307004,152689,154315,16714,20135,23245,21883,18973,33230,39115,50020,23253,20710,25270,8948,5508,39.7,232717,221647,52159,39726,232717,114663,118054,39726,18188,21538
0500000US17113,"McLean County, Illinois",172418,84537,87881,9621,11267,9778,15260,20677,23555,20660,20910,9852,10060,11763,6040,2975,32.9,134850,120874,26504,20778,134850,65048,69802,20778,9177,11601
0500000US17115,"Macon County, Illinois",106550,51064,55486,6525,6650,6428,7505,6601,12046,11501,13682,7942,7594,11353,5792,2931,41.6,82926,78505,24324,20076,82926,39162,43764,20076,8699,11377
0500000US17119,"Madison County, Illinois",265759,128886,136873,15184,15935,16591,17151,14962,36189,32369,36367,18614,19017,24030,12118,7232,40.4,207512,196898,54845,43380,207512,98791,108721,43380,18344,25036
0500000US17143,"Peoria County, Illinois",185006,89857,95149,13017,13047,11262,12417,11663,24513,24041,21967,11823,12214,17256,8203,3583,37.3,140584,132389,35832,29042,140584,67210,73374,29042,12642,16400
0500000US17161,"Rock Island County, Illinois",144784,70339,74445,9097,9003,9365,8691,8604,19563,17353,16705,10180,9668,14248,8570,3737,39,112575,106873,32291,26555,112575,54691,57884,26555,11580,14975
0500000US17163,"St. Clair County, Illinois",262759,126820,135939,16800,17984,17183,15895,16909,34867,32710,35843,19080,16966,21942,10525,6055,38.7,200290,191372,48453,38522,200290,94774,105516,38522,16436,22086
0500000US17167,"Sangamon County, Illinois",197499,95069,102430,11261,13618,11999,12515,12245,24302,24821,26185,14883,12755,19171,8917,4827,40,152724,146074,40456,32915,152724,71923,80801,32915,13896,19019
0500000US17179,"Tazewell County, Illinois",134385,66304,68081,7648,8894,8305,8260,6724,16661,17430,17523,9749,9039,13365,6469,4318,41.2,104078,100395,29144,24152,104078,50852,53226,24152,10596,13556
0500000US17183,"Vermilion County, Illinois",78111,39079,39032,5125,5008,5235,5087,4825,9181,9012,9765,5899,4594,8041,4437,1902,40.5,59486,56524,17332,14380,59486,29437,30049,14380,6524,7856
0500000US17197,"Will County, Illinois",689529,342171,347358,40824,47544,54711,52877,46021,78927,95608,106036,45861,37752,51293,23905,8170,37.9,512171,483230,106207,83368,512171,251610,260561,83368,36932,46436
0500000US17199,"Williamson County, Illinois",67560,34537,33023,4512,2887,4873,3867,3906,8823,8772,8426,4336,4866,7263,3486,1543,41.3,52473,50434,15337,12292,52473,26366,26107,12292,5379,6913
0500000US17201,"Winnebago County, Illinois",285873,139747,146126,17528,18683,18868,18526,17533,35354,34556,38259,18741,20349,27727,13787,5962,39.8,218708,208511,58851,47476,218708,104923,113785,47476,20868,26608
0500000US18003,"Allen County, Indiana",370404,180930,189474,26366,26549,27047,25545,25036,50488,45503,46734,22730,23583,30059,14008,6756,35.8,274040,259873,63922,50823,274040,131873,142167,50823,22187,28636
0500000US18005,"Bartholomew County, Indiana",81402,41383,40019,5619,5902,4947,4903,5576,11285,10091,10340,5357,4856,7234,3831,1461,37.5,61921,59051,15513,12526,61921,30706,31215,12526,5459,7067
0500000US18019,"Clark County, Indiana",116031,56178,59853,7088,8127,7153,6736,7216,16291,15221,15522,7052,8308,10728,4403,2186,38.7,89295,85228,22016,17317,89295,42629,46666,17317,7523,9794
0500000US18035,"Delaware County, Indiana",115603,56422,59181,5917,5178,6016,10417,17394,12736,11217,13798,6562,7280,10942,5732,2414,35.4,94428,84040,23645,19088,94428,45346,49082,19088,8366,10722
0500000US18039,"Elkhart County, Indiana",203781,100665,103116,15459,15148,16195,14687,12394,25530,26678,24757,12498,12025,16185,7326,4899,36.2,147283,139562,34626,28410,147283,72092,75191,28410,12369,16041
0500000US18043,"Floyd County, Indiana",76990,37782,39208,4398,4777,4916,4972,5104,9641,9353,10849,5893,5022,7238,3283,1544,40.4,59905,57075,14593,12065,59905,29271,30634,12065,5367,6698
0500000US18053,"Grant County, Indiana",66937,32352,34585,3563,4296,3725,5017,6148,6788,7001,8676,5045,4161,7172,3923,1422,39.9,53013,48883,14996,12517,53013,24859,28154,12517,5403,7114
0500000US18057,"Hamilton County, Indiana",316373,153095,163278,21762,23518,27142,22114,15523,38927,46968,48378,19092,16235,22376,9564,4774,36.9,228476,219206,44692,36714,228476,110082,118394,36714,16704,20010
0500000US18059,"Hancock County, Indiana",73717,36577,37140,4004,5247,4822,4351,5192,8491,9329,10984,4743,5100,6945,3317,1192,39.9,56315,54133,14670,11454,56315,27460,28855,11454,5173,6281
0500000US18063,"Hendricks County, Indiana",160610,79683,80927,10080,10424,12244,11433,9708,21314,21896,22833,11627,8411,12323,5684,2633,36.8,119628,114014,25326,20640,119628,59402,60226,20640,9209,11431
0500000US18067,"Howard County, Indiana",82568,40320,42248,4426,4592,6120,5316,4843,9748,8961,11586,5972,5225,9195,3812,2772,41.4,63755,60704,18974,15779,63755,30511,33244,15779,6725,9054
0500000US18081,"Johnson County, Indiana",151982,73792,78190,10376,12929,8811,10239,9527,19446,20915,20283,8791,8987,12875,7173,1630,37.5,113379,107694,26676,21678,113379,55099,58280,21678,9311,12367
0500000US18085,"Kosciusko County, Indiana",79092,39019,40073,5068,5130,5617,5256,5138,10222,8873,10399,5517,5254,7257,3765,1596,38.7,59933,56790,16150,12618,59933,29448,30485,12618,5630,6988
0500000US18089,"Lake County, Indiana",485846,234662,251184,30066,33642,31348,33168,31176,59855,61557,62987,36781,30368,42815,22190,9893,38.6,369272,351898,92419,74898,369272,175313,193959,74898,31982,42916
0500000US18091,"LaPorte County, Indiana",110015,57378,52637,6317,6341,7639,6118,6986,13822,14283,14789,8427,7088,10874,5767,1564,40.8,86042,82620,22854,18205,86042,44412,41630,18205,7974,10231
0500000US18095,"Madison County, Indiana",129296,63677,65619,7314,7437,8401,8924,7372,16720,15154,18165,8060,8863,13215,6985,2686,40.4,100978,95846,28275,22886,100978,48903,52075,22886,9867,13019
0500000US18097,"Marion County, Indiana",941229,453482,487747,70050,67486,60817,58035,67266,157064,119872,116438,60510,52955,65037,32165,13534,34.3,706516,671901,145356,110736,706516,333394,373122,110736,45834,64902
0500000US18105,"Monroe County, Indiana",145496,72895,72601,6369,6125,6304,16614,28055,21250,14039,13715,7468,8308,9768,5339,2142,28.5,122620,102925,22257,17249,122620,60719,61901,17249,7545,9704
0500000US18109,"Morgan County, Indiana",69698,34325,35373,3633,4115,4727,4658,4238,7529,8188,10874,5277,5359,6857,3045,1198,42.3,54211,51927,13740,11100,54211,26400,27811,11100,5137,5963
0500000US18127,"Porter County, Indiana",167791,82455,85336,9067,11112,10388,11765,11379,19943,22057,22413,10897,12330,16132,7576,2732,39.1,130019,122872,33618,26440,130019,63232,66787,26440,11823,14617
0500000US18141,"St. Joseph County, Indiana",269141,130979,138162,17574,16466,19356,21001,20693,33740,32948,32726,16334,18519,22546,10026,7212,36.5,204804,188429,51302,39784,204804,97805,106999,39784,17223,22561
0500000US18157,"Tippecanoe County, Indiana",188059,96352,91707,11947,12224,9377,17874,33314,25975,19663,18974,9837,8834,11611,5534,2895,28.2,148942,129856,25217,20040,148942,75845,73097,20040,8553,11487
0500000US18163,"Vanderburgh County, Indiana",181721,88429,93292,10800,11127,11195,12125,12743,26306,20607,22615,12682,12631,15964,8330,4596,37.7,142045,133941,36122,28890,142045,67428,74617,28890,12144,16746
0500000US18167,"Vigo County, Indiana",107931,54647,53284,6202,7135,5545,7863,11980,14092,12676,12503,6583,6403,9970,4811,2168,35.7,85514,78272,20778,16949,85514,43049,42465,16949,7303,9646
0500000US18177,"Wayne County, Indiana",66568,31948,34620,3890,4561,3526,4439,4202,7941,7539,8652,4719,4508,6913,3826,1852,40.4,51974,49504,15586,12591,51974,24717,27257,12591,5153,7438
0500000US19013,"Black Hawk County, Iowa",132904,66262,66642,8317,9200,6856,9143,15668,16834,14500,14677,8798,8201,11199,5801,3710,35.2,104450,95828,25880,20710,104450,50873,53577,20710,9282,11428
0500000US19049,"Dallas County, Iowa",84516,41755,42761,6558,7559,6333,4741,4434,12421,13100,11063,4104,4341,5670,3020,1172,35.2,60744,58489,12572,9862,60744,29676,31068,9862,4315,5547
0500000US19061,"Dubuque County, Iowa",97003,47974,49029,6185,6215,5953,7440,6195,12406,10582,12250,6788,6485,8815,5333,2356,38,74834,69704,20309,16504,74834,36515,38319,16504,7275,9229
0500000US19103,"Johnson County, Iowa",146547,72310,74237,8634,8007,8367,14327,20374,24800,17273,14667,8730,6100,9190,3521,2557,30,117034,102661,19750,15268,117034,57329,59705,15268,6727,8541
0500000US19113,"Linn County, Iowa",221661,109457,112204,14463,14673,14335,14223,14455,30656,28342,29242,14545,13691,18423,9845,4768,37.6,169283,161753,40507,33036,169283,82911,86372,33036,14614,18422
0500000US19153,"Polk County, Iowa",474045,233139,240906,34791,33646,32065,31186,29317,73770,64040,61029,27365,28671,34611,15954,7600,35.3,354799,336188,74600,58165,354799,172797,182002,58165,25266,32899
0500000US19155,"Pottawattamie County, Iowa",93582,46344,47238,5569,5938,6645,6234,6504,10930,10841,12448,7243,5795,8886,4327,2222,39.1,71847,68211,18979,15435,71847,35345,36502,15435,6820,8615
0500000US19163,"Scott County, Iowa",172474,84922,87552,11077,11647,12223,10996,10074,22793,22697,21743,11787,11092,15216,7749,3380,37.9,131007,124536,33496,26345,131007,63525,67482,26345,11808,14537
0500000US19169,"Story County, Iowa",97090,49721,47369,4414,3919,4347,12756,20006,13347,8819,9395,5146,3815,6109,3194,1823,26.9,81542,63917,13322,11126,81542,41568,39974,11126,4989,6137
0500000US19193,"Woodbury County, Iowa",102779,51248,51531,7630,7008,7912,7398,7456,13844,12292,11951,6155,5933,8888,4790,1522,35.1,75581,71020,19441,15200,75581,36788,38793,15200,6481,8719
0500000US20015,"Butler County, Kansas",67025,33810,33215,3982,4357,5218,5255,4125,7864,8517,8903,5208,3933,5404,2869,1390,38.4,50066,47191,11900,9663,50066,25268,24798,9663,4362,5301
0500000US20045,"Douglas County, Kansas",119440,59518,59922,6633,5689,5735,14354,17848,17889,13248,12339,6218,6113,8246,3517,1611,30,97536,80886,17605,13374,97536,48224,49312,13374,6033,7341
0500000US20091,"Johnson County, Kansas",584451,286329,298122,37543,41285,41348,37900,33414,79101,81016,79955,37915,34986,47597,21215,11176,37.6,439347,421201,100966,79988,439347,212176,227171,79988,34972,45016
0500000US20103,"Leavenworth County, Kansas",80204,43829,36375,4948,5316,5557,4859,5616,11064,12248,9973,6153,3779,6374,3531,786,36.7,61146,58642,12590,10691,61146,32880,28266,10691,4673,6018
0500000US20161,"Riley County, Kansas",73343,39642,33701,4804,3644,2079,7590,18256,13153,6353,5912,2762,2619,3440,1874,857,25.2,61362,50069,7876,6171,61362,32853,28509,6171,2755,3416
0500000US20173,"Sedgwick County, Kansas",511995,253144,258851,37131,39880,34840,34092,35947,73045,61894,61510,33879,30598,40658,18542,9979,35.1,378317,357234,88667,69179,378317,185051,193266,69179,30871,38308
0500000US20177,"Shawnee County, Kansas",178146,86464,91682,11673,12975,11054,10637,11406,22617,20892,21776,12756,11847,16937,8799,4777,38.4,135319,130264,37084,30513,135319,64321,70998,30513,13623,16890
0500000US20209,"Wyandotte County, Kansas",163831,81019,82812,13584,11844,13998,10666,10414,24151,21673,19225,10524,8949,11178,5421,2204,33.9,117638,111766,24400,18803,117638,57314,60324,18803,8058,10745
0500000US21015,"Boone County, Kentucky",128536,63585,64951,8773,9371,9705,9868,8326,15840,17321,18534,7518,7720,10066,4319,1175,37,93955,89183,20209,15560,93955,45298,48657,15560,6822,8738
0500000US21029,"Bullitt County, Kentucky",79151,39161,39990,4187,5551,5027,4947,5314,9727,10303,11997,5416,5194,7516,2822,1150,39.9,61249,58219,14076,11488,61249,29737,31512,11488,5405,6083
0500000US21037,"Campbell County, Kentucky",92211,44630,47581,5227,6168,4747,6518,6696,13196,11243,12207,6656,6233,7748,4115,1457,37.7,72675,68449,17466,13320,72675,34814,37861,13320,5809,7511
0500000US21047,"Christian County, Kentucky",72351,38489,33862,6933,5096,5255,4491,9065,12142,7509,6867,3504,3630,4258,2838,763,28.5,52529,48590,10046,7859,52529,28174,24355,7859,3322,4537
0500000US21059,"Daviess County, Kentucky",99674,48401,51273,7205,6272,6522,6814,6196,12722,11914,12579,7142,5896,9455,4612,2345,38.9,75735,71412,19789,16412,75735,36290,39445,16412,7020,9392
0500000US21067,"Fayette County, Kentucky",318449,156230,162219,19815,18910,17722,23087,32768,49522,41856,38850,19457,17839,22903,11279,4441,34.4,251618,232421,48279,38623,251618,122217,129401,38623,16310,22313
0500000US21093,"Hardin County, Kentucky",107316,53126,54190,7163,6298,8401,7720,7041,14589,14259,13776,7914,5948,8737,4120,1350,37.3,80789,76627,17776,14207,80789,39605,41184,14207,6131,8076
0500000US21111,"Jefferson County, Kentucky",765352,370139,395213,48741,46753,47479,46903,47788,112463,95313,99455,54211,49429,67127,33133,16557,38.3,593754,565871,148316,116817,593754,282313,311441,116817,49453,67364
0500000US21117,"Kenton County, Kentucky",164945,81187,83758,11177,12293,10075,9610,10341,23893,21079,22438,11921,10146,13130,6291,2551,37.4,125068,120591,26991,21972,125068,61082,63986,21972,9461,12511
0500000US21145,"McCracken County, Kentucky",65162,31405,33757,4102,3964,3349,4544,4029,7614,7568,8364,4743,4533,6912,3893,1547,40.7,50897,48565,15391,12352,50897,24028,26869,12352,5254,7098
0500000US21151,"Madison County, Kentucky",89547,42697,46850,5031,5886,5105,10105,8612,11287,10544,10921,5855,4640,7054,3064,1443,34,70529,61863,14606,11561,70529,32896,37633,11561,5115,6446
0500000US21185,"Oldham County, Kentucky",65560,33660,31900,3167,4388,5504,5313,4130,6446,10307,10572,4279,3430,5373,1918,733,38.4,48854,46328,10218,8024,48854,25438,23416,8024,3716,4308
0500000US21227,"Warren County, Kentucky",125532,61841,63691,8358,7268,8588,12136,13456,16354,15402,14519,7489,6337,9541,3916,2168,33.1,97048,85656,19052,15625,97048,47291,49757,15625,6977,8648
0500000US22005,"Ascension Parish, Louisiana",121587,60951,60636,8287,10240,10283,9044,5944,16660,17307,17007,6334,7032,8355,3940,1154,35.1,88231,82451,16644,13449,88231,42638,45593,13449,6050,7399
0500000US22015,"Bossier Parish, Louisiana",126057,63404,62653,9319,9432,7781,8036,9234,19929,15294,15248,6699,8262,9938,5199,1686,34.7,94243,89279,20716,16823,94243,46328,47915,16823,7141,9682
0500000US22017,"Caddo Parish, Louisiana",248851,118005,130846,17727,15920,17038,14971,16501,35012,29953,29649,17273,15417,22523,12344,4523,36.9,188436,180281,48206,39390,188436,87421,101015,39390,16710,22680
0500000US22019,"Calcasieu Parish, Louisiana",200601,98097,102504,13988,14029,13603,15335,11237,29262,24839,24628,15131,10626,16544,8338,3041,36.2,150693,141191,32959,27923,150693,71960,78733,27923,12211,15712
0500000US22033,"East Baton Rouge Parish, Louisiana",447037,213382,233655,29196,27164,27810,31599,47653,69563,50721,50813,29117,24672,35565,16769,6395,33.3,345899,319473,72418,58729,345899,162434,183465,58729,24750,33979
0500000US22045,"Iberia Parish, Louisiana",73273,34529,38744,5230,4742,6406,5355,5174,7416,8901,9926,5330,4370,5890,3463,1070,36.8,53562,50463,13118,10423,53562,25639,27923,10423,4801,5622
0500000US22051,"Jefferson Parish, Louisiana",436523,211470,225053,27582,26403,25935,24885,25350,65073,53540,57361,33120,27364,40899,19541,9470,39,340782,327483,85172,69910,340782,163050,177732,69910,29943,39967
0500000US22055,"Lafayette Parish, Louisiana",241398,117655,123743,16925,15732,15497,15822,16467,42724,31422,29499,15085,13807,16841,8077,3500,34.1,183933,174785,36523,28418,183933,87965,95968,28418,12299,16119
0500000US22057,"Lafourche Parish, Louisiana",98305,48019,50286,5957,4495,8168,7704,5639,14167,11720,14103,6652,5603,8528,4048,1521,38,75262,70548,17025,14097,75262,36468,38794,14097,6186,7911
0500000US22063,"Livingston Parish, Louisiana",140138,70223,69915,9986,11122,9492,10102,8065,19363,19953,18434,8086,7785,11584,3901,2265,36.3,103545,97598,22580,17750,103545,51063,52482,17750,8377,9373
0500000US22071,"Orleans Parish, Louisiana",391495,186998,204497,23365,24162,19566,22115,26822,73170,51089,48544,26576,25154,31103,13149,6680,35.7,311689,295592,65032,50932,311689,146223,165466,50932,21671,29261
0500000US22073,"Ouachita Parish, Louisiana",156983,75476,81507,11070,10414,11364,11303,11054,22277,19386,18877,8896,10188,12989,6697,2468,35.6,117144,110957,28051,22154,117144,55053,62091,22154,9306,12848
0500000US22079,"Rapides Parish, Louisiana",132424,64622,67802,9054,8112,10244,9887,7719,17033,16278,16636,8649,8446,11838,5480,3048,37.4,99242,93852,24661,20366,99242,47354,51888,20366,8747,11619
0500000US22097,"St. Landry Parish, Louisiana",83883,40045,43838,6278,6802,5886,5774,5817,9878,9189,10403,6579,4339,7487,4484,967,36.5,61167,57601,14913,12938,61167,28765,32402,12938,5615,7323
0500000US22103,"St. Tammany Parish, Louisiana",253602,123200,130402,14949,15543,19348,17132,13300,29444,33506,34484,17215,18263,25314,10157,4947,39.7,192423,183542,51595,40418,192423,92141,100282,40418,18277,22141
0500000US22105,"Tangipahoa Parish, Louisiana",130710,63659,67051,8974,9671,7365,10356,10780,16734,17492,15333,8245,8029,11337,4846,1548,35.9,98799,91936,22798,17731,98799,47219,51580,17731,8051,9680
0500000US22109,"Terrebonne Parish, Louisiana",113220,55974,57246,8009,7935,8398,7305,8033,16403,13528,14657,7161,6661,9692,3699,1739,35.5,84031,79670,19050,15130,84031,40564,43467,15130,6472,8658
0500000US23001,"Androscoggin County, Maine",107319,52369,54950,6295,7204,5679,6976,6324,13300,12934,15562,8596,6479,10504,5230,2236,40.4,84326,79834,21647,17970,84326,41136,43190,17970,7987,9983
0500000US23003,"Aroostook County, Maine",67959,33609,34350,3339,3670,3184,3877,4011,6857,6812,9580,5948,5412,8781,4639,1849,47.5,55433,53222,18293,15269,55433,27179,28254,15269,6922,8347
0500000US23005,"Cumberland County, Maine",292041,141354,150687,14640,17228,13922,17847,18505,38530,35690,43114,23576,18883,29560,12907,7639,42.2,235922,225140,60552,50106,235922,112821,123101,50106,21917,28189
0500000US23011,"Kennebec County, Maine",120569,59398,61171,5709,7229,6523,7466,7336,14063,13997,17341,9833,9407,12642,6632,2391,43.3,96781,91969,26471,21665,96781,46904,49877,21665,9733,11932
0500000US23019,"Penobscot County, Maine",151806,74920,76886,6918,8876,6953,11154,10502,20535,16651,21098,10964,11628,15241,7387,3899,42,123825,115297,33655,26527,123825,60487,63338,26527,12029,14498
0500000US23031,"York County, Maine",202343,98366,103977,9595,9079,13296,11605,10485,23756,23638,29730,16519,16113,22725,9469,6333,44.9,162865,156352,47158,38527,162865,77693,85172,38527,17314,21213
0500000US24001,"Allegany County, Maryland",72130,37688,34442,3292,3730,3367,5267,6064,9100,8001,9636,4836,4740,7830,4319,1948,40.8,59374,55102,16685,14097,59374,30846,28528,14097,6298,7799
0500000US24003,"Anne Arundel County, Maryland",568346,281988,286358,34862,35071,36220,33031,38334,80834,74478,81766,42134,32194,48170,21705,9547,38,441025,422575,98328,79422,441025,216671,224354,79422,34946,44476
0500000US24005,"Baltimore County, Maryland",831026,393924,437102,49008,52364,47337,53504,52030,116426,100476,110319,57771,54246,75632,39342,22571,39.4,651488,616862,170622,137545,651488,302839,348649,137545,57922,79623
0500000US24009,"Calvert County, Maryland",91251,45190,46061,4114,6028,6693,7419,4527,10497,11315,14905,6498,6226,8198,3792,1039,40.6,69680,66632,16940,13029,69680,33736,35944,13029,6056,6973
0500000US24013,"Carroll County, Maryland",167656,83174,84482,8345,9851,11283,11594,9803,18146,18813,27989,12354,12152,16643,6918,3765,43.2,131026,124927,34432,27326,131026,64352,66674,27326,12245,15081
0500000US24015,"Cecil County, Maryland",102603,51190,51413,5533,7109,6678,6366,6395,13064,12660,14614,8275,6928,9473,3536,1972,40,78943,76027,19020,14981,78943,38804,40139,14981,7118,7863
0500000US24017,"Charles County, Maryland",157705,76601,81104,9150,9982,11980,11015,10275,20392,20182,26090,11059,8710,12103,4919,1848,38.1,119508,113604,23436,18870,119508,56616,62892,18870,8410,10460
0500000US24021,"Frederick County, Maryland",247591,121850,125741,14498,16080,16767,16915,15365,30761,32104,38559,18339,14357,20527,8767,4552,39.3,189393,179651,42496,33846,189393,92498,96895,33846,14981,18865
0500000US24025,"Harford County, Maryland",251032,122387,128645,13986,15220,16784,15573,15811,30431,30055,38744,19580,16288,23424,10764,4372,41.2,194746,186503,48503,38560,194746,93386,101360,38560,16889,21671
0500000US24027,"Howard County, Maryland",317233,154895,162338,19059,21156,23448,20711,20354,37341,44924,48019,21209,19602,25896,10558,4956,38.6,239226,229060,52743,41410,239226,114770,124456,41410,18349,23061
0500000US24031,"Montgomery County, Maryland",1043863,503189,540674,66937,68509,67207,64072,61466,134705,143552,149474,72095,64237,86306,44589,20714,39,799566,766525,188340,151609,799566,378556,421010,151609,65168,86441
0500000US24033,"Prince George's County, Maryland",908049,437076,470973,59828,60612,50990,58878,65913,134627,121578,129344,61569,52885,71189,30759,9877,36.7,704444,665440,142620,111825,704444,333429,371015,111825,46401,65424
0500000US24037,"St. Mary's County, Maryland",112587,55251,57336,6915,6900,9093,7945,7477,16523,13259,16490,7946,6074,8337,4356,1272,35.9,84945,80754,17381,13965,84945,41548,43397,13965,6468,7497
0500000US24043,"Washington County, Maryland",150292,76188,74104,8607,9384,9463,8452,9179,20096,18672,21723,10011,10221,13671,7779,3034,40.5,116928,113020,29521,24484,116928,59278,57650,24484,10855,13629
0500000US24045,"Wicomico County, Maryland",102577,48998,53579,5856,6204,6447,9300,9833,12743,11244,12584,7134,5839,9150,4546,1697,35.8,79954,72201,19557,15393,79954,37013,42941,15393,6673,8720
0500000US24510,"Baltimore city, Maryland",614664,289086,325578,40345,34722,34241,36421,45951,116182,74745,75699,39910,37200,46788,22554,9906,34.9,485510,459539,101363,79248,485510,223923,261587,79248,31457,47791
0500000US25001,"Barnstable County, Massachusetts",214276,102271,112005,8353,8976,10070,10570,10633,18401,18388,28789,16734,20052,35341,18705,9264,53.1,180436,174967,75575,63310,180436,85732,94704,63310,28077,35233
0500000US25003,"Berkshire County, Massachusetts",126903,60848,66055,4749,6081,6931,8222,8701,13409,12607,17635,10884,9928,15681,8721,3354,46.7,104774,98681,33206,27756,104774,49605,55169,27756,12278,15478
0500000US25005,"Bristol County, Massachusetts",558324,271369,286955,29150,33906,32733,35182,37818,69840,69479,82044,40464,36382,51618,25932,13776,40.8,442157,419073,111914,91326,442157,211347,230810,91326,39040,52286
0500000US25009,"Essex County, Massachusetts",779018,376004,403014,42418,43675,52095,50732,53474,93218,92521,113770,59387,50280,72589,34635,20224,41.3,610568,577949,158623,127448,610568,289291,321277,127448,54415,73033
0500000US25011,"Franklin County, Massachusetts",70382,34446,35936,3160,3030,3749,3769,3675,8266,8523,10031,6381,6032,8763,3489,1514,45.9,57971,56267,17448,13766,57971,27780,30191,13766,6329,7437
0500000US25013,"Hampden County, Massachusetts",468467,226014,242453,26259,28006,29266,33586,36400,60618,52895,63677,31250,32267,41996,21309,10938,38.9,365352,342990,93048,74243,365352,173477,191875,74243,31507,42736
0500000US25015,"Hampshire County, Massachusetts",161816,75944,85872,6007,7352,6690,17954,23679,16891,16216,19600,10766,10343,15593,6853,3872,36.6,137241,117076,32341,26318,137241,62930,74311,26318,11598,14720
0500000US25017,"Middlesex County, Massachusetts",1589774,776787,812987,86841,83979,93638,102935,112466,242002,206889,225301,107860,96087,130379,67484,33913,38.5,1268164,1197679,286804,231776,1268164,612794,655370,231776,99716,132060
0500000US25021,"Norfolk County, Massachusetts",697181,334100,363081,37315,38915,44677,46188,43606,86150,86619,103961,51557,44601,62735,34100,16757,41,548579,521159,140865,113592,548579,258581,289998,113592,48212,65380
0500000US25023,"Plymouth County, Massachusetts",513565,249720,263845,27264,28529,34921,35552,31536,54463,59179,78399,38456,36621,53254,26063,9328,42.4,400998,379499,110562,88645,400998,191864,209134,88645,38792,49853
0500000US25025,"Suffolk County, Massachusetts",784230,380262,403968,42459,34422,35432,55482,74976,180999,100568,90026,43700,37222,50918,25022,13004,32.7,650257,599497,110634,88944,650257,312294,337963,88944,37192,51752
0500000US25027,"Worcester County, Massachusetts",819589,404691,414898,44648,46020,53012,57530,57115,103151,99002,123140,61963,52192,70549,34036,17231,40.1,643152,607502,152350,121816,643152,314226,328926,121816,53807,68009
0500000US26005,"Allegan County, Michigan",115548,57740,57808,7610,7354,8540,7397,6185,14085,13625,15715,9230,7458,11029,4812,2508,39.4,87120,83661,22486,18349,87120,43175,43945,18349,8298,10051
0500000US26017,"Bay County, Michigan",104747,51999,52748,5410,5910,6205,6298,5705,12611,12227,14138,7678,8404,11208,6529,2424,43.1,83333,79813,25270,20161,83333,40634,42699,20161,8877,11284
0500000US26021,"Berrien County, Michigan",154010,75592,78418,8947,10502,8648,9412,9453,18051,17434,20428,11487,11226,16476,8132,3814,41.6,119773,114409,35574,28422,119773,58049,61724,28422,12766,15656
0500000US26025,"Calhoun County, Michigan",134386,64953,69433,8483,8015,8604,10396,8250,16269,15271,17610,9660,8589,13463,7270,2506,39.6,103340,96720,27693,23239,103340,49695,53645,23239,10450,12789
0500000US26037,"Clinton County, Michigan",77888,38323,39565,4086,5766,4584,5287,5096,8901,9134,11327,5880,5128,7379,3534,1786,40.1,60015,56985,15698,12699,60015,29310,30705,12699,6086,6613
0500000US26045,"Eaton County, Michigan",109160,53471,55689,5537,6335,7188,7508,6608,13926,12023,14908,7940,8529,11200,5437,2021,40.9,85944,81479,23113,18658,85944,41434,44510,18658,8261,10397
0500000US26049,"Genesee County, Michigan",408615,196719,211896,24464,28588,23938,26893,25995,48504,48826,56010,30513,27576,38916,18927,9465,39.9,314548,301141,83797,67308,314548,148757,165791,67308,29245,38063
0500000US26055,"Grand Traverse County, Michigan",92084,44676,47408,4806,5054,5786,5162,4865,12027,10574,12458,6814,7330,10256,4309,2643,43.4,73027,70257,21720,17208,73027,35286,37741,17208,7517,9691
0500000US26065,"Ingham County, Michigan",288051,139189,148862,16358,15202,16811,26876,40092,39774,31326,31868,18175,15590,21582,9804,4593,31.8,230417,202168,44547,35979,230417,110871,119546,35979,15655,20324
0500000US26073,"Isabella County, Michigan",71282,34754,36528,3137,3751,3359,8859,13835,9300,6152,6758,3721,4210,4734,2556,910,27.8,58893,47816,11142,8200,58893,28359,30534,8200,3606,4594
0500000US26075,"Jackson County, Michigan",158460,80892,77568,8800,9700,9924,10049,10034,19044,18704,22385,11518,11691,15280,7986,3345,41.2,124142,117584,33494,26611,124142,63359,60783,26611,12210,14401
0500000US26077,"Kalamazoo County, Michigan",261654,127763,133891,15670,14330,17440,18322,33058,33247,29922,31137,16073,15168,21571,10591,5125,34.7,204692,187229,46013,37287,204692,99074,105618,37287,16332,20955
0500000US26081,"Kent County, Michigan",642173,316715,325458,44117,45273,42675,43369,44791,99586,79640,81260,41846,37478,46912,23844,11382,35.1,483332,457490,103799,82138,483332,235054,248278,82138,35929,46209
0500000US26087,"Lapeer County, Michigan",88340,45360,42980,4553,5198,5042,5734,4845,9743,9395,14658,7781,6342,9266,4465,1318,44.6,69915,67237,18513,15049,69915,36017,33898,15049,7187,7862
0500000US26091,"Lenawee County, Michigan",98504,50221,48283,5094,5964,5930,6746,6530,11409,11676,13552,6849,7500,10507,4348,2399,42.1,77317,72890,21765,17254,77317,38873,38444,17254,7749,9505
0500000US26093,"Livingston County, Michigan",188624,94740,93884,9693,10713,12342,13555,10878,19465,21499,31027,15530,13936,18644,9102,2240,43.5,147029,140193,38803,29986,147029,73179,73850,29986,14116,15870
0500000US26099,"Macomb County, Michigan",867730,422671,445059,47806,51512,52429,52920,53882,112350,106367,127094,64734,57662,80803,38714,21457,41,681009,654773,173489,140974,681009,326909,354100,140974,60525,80449
0500000US26103,"Marquette County, Michigan",66435,33826,32609,3708,3108,3571,4212,7696,8062,6912,7592,4909,4817,7013,3227,1608,38.4,54032,49569,14788,11848,54032,27406,26626,11848,5738,6110
0500000US26111,"Midland County, Michigan",83462,41095,42367,4059,4855,5463,5553,4933,10071,10131,11852,7239,4749,7788,4538,2231,42.6,65598,62614,17968,14557,65598,31843,33755,14557,6345,8212
0500000US26115,"Monroe County, Michigan",149208,73674,75534,8087,7881,10163,9980,8849,16725,17643,21836,11605,11237,15017,7055,3130,42.2,116339,110942,31605,25202,116339,57257,59082,25202,11543,13659
0500000US26121,"Muskegon County, Michigan",173408,86153,87255,10965,10349,11570,12120,10657,21946,20306,22914,12568,12273,16258,7998,3484,39.1,132825,127396,35044,27740,132825,65467,67358,27740,12249,15491
0500000US26125,"Oakland County, Michigan",1243970,606839,637131,68455,69765,78581,77910,74757,159354,155408,183112,97599,80827,116482,53651,28069,41,976135,933226,243768,198202,976135,469808,506327,198202,86146,112056
0500000US26139,"Ottawa County, Michigan",282250,138278,143972,17774,19318,19897,23811,26281,34124,32155,35586,16179,17873,22580,9641,7031,35,213309,195148,49115,39252,213309,103834,109475,39252,17587,21665
0500000US26145,"Saginaw County, Michigan",192326,94082,98244,11015,11372,11484,12052,15123,22865,20989,25112,12398,14792,19956,11193,3975,41,150937,143449,44320,35124,150937,72117,78820,35124,15438,19686
0500000US26147,"St. Clair County, Michigan",159587,79340,80247,8110,8242,10719,10691,9416,17331,18089,24275,13741,10938,16551,8517,2967,43.6,125451,120067,34486,28035,125451,61692,63759,28035,12793,15242
0500000US26155,"Shiawassee County, Michigan",68554,33880,34674,3646,3898,4062,4714,3948,8061,7800,10273,5587,4775,7012,3359,1419,41.8,53890,51392,14563,11790,53890,26626,27264,11790,5284,6506
0500000US26159,"Van Buren County, Michigan",75223,37503,37720,4497,4132,5613,5304,4010,8344,9053,9929,4661,7024,7842,3261,1553,40.7,57243,54841,16588,12656,57243,28140,29103,12656,5928,6728
0500000US26161,"Washtenaw County, Michigan",364709,180083,184626,18243,18731,20130,33803,46951,52330,40803,44603,20610,21512,28792,12347,5854,33.5,295433,262377,59498,46993,295433,144932,150501,46993,20922,26071
0500000US26163,"Wayne County, Michigan",1749366,841906,907460,114715,116280,114554,115008,117825,237381,210238,236759,126086,108714,146480,70758,34568,37.8,1329922,1268218,314341,251806,1329922,628298,701624,251806,105775,146031
0500000US27003,"Anoka County, Minnesota",345957,172322,173635,21549,23526,23691,22710,20530,43929,45858,51909,25469,22217,28226,12133,4210,38.1,262560,250186,57589,44569,262560,129861,132699,44569,19794,24775
0500000US27013,"Blue Earth County, Minnesota",66441,33206,33235,3548,3546,3332,6166,11661,8595,6582,6636,3752,3777,4846,2592,1408,30.5,53812,46001,11338,8846,53812,26687,27125,8846,4013,4833
0500000US27019,"Carver County, Minnesota",100262,49993,50269,6180,8205,7367,7508,5205,12005,13991,15710,7802,5337,6280,3363,1309,38,73539,69782,14088,10952,73539,36270,37269,10952,4920,6032
0500000US27037,"Dakota County, Minnesota",417486,205671,211815,27295,28070,29948,26140,24674,53909,55677,60414,30942,25464,33057,15231,6665,37.6,314504,301583,69545,54953,314504,152742,161762,54953,24285,30668
0500000US27053,"Hennepin County, Minnesota",1232483,609092,623391,81028,77581,71440,70937,79380,210356,161814,159838,81499,75911,93771,43891,25037,36.3,959615,917096,207938,162699,959615,470292,489323,162699,70700,91999
0500000US27109,"Olmsted County, Minnesota",153102,74975,78127,10870,10860,10271,8826,9187,21933,19839,18639,11598,8247,12086,7296,3450,37.4,115400,110998,27281,22832,115400,55852,59548,22832,10228,12604
0500000US27123,"Ramsey County, Minnesota",540649,263213,277436,38167,36367,32485,34794,40186,89381,64337,64266,33356,33710,42081,20077,11442,34.9,414179,390335,93553,73600,414179,198532,215647,73600,31274,42326
0500000US27131,"Rice County, Minnesota",65622,33703,31919,3770,4292,3905,4911,6692,7210,7979,8928,4056,4091,5538,2928,1322,37.6,51537,46260,12196,9788,51537,26621,24916,9788,4432,5356
0500000US27137,"St. Louis County, Minnesota",199980,100287,99693,10063,9310,12276,14561,18185,22336,21659,24593,15918,15028,20565,10200,5286,41.6,161727,148701,43572,36051,161727,80569,81158,36051,16497,19554
0500000US27139,"Scott County, Minnesota",143680,71431,72249,10343,11813,11617,9267,8059,16855,21840,22627,9520,7947,8435,3195,2162,36.7,103307,99706,18195,13792,103307,50727,52580,13792,6358,7434
0500000US27141,"Sherburne County, Minnesota",93528,47597,45931,6396,8666,6409,6711,5263,12117,13306,13857,6775,4204,6094,2410,1320,35.8,67573,63589,12443,9824,67573,34237,33336,9824,4566,5258
0500000US27145,"Stearns County, Minnesota",155652,78735,76917,9893,10653,9008,12991,16531,19583,17570,18658,9939,9005,12115,6484,3222,34.4,120032,109380,27026,21821,120032,60417,59615,21821,10045,11776
0500000US27163,"Washington County, Minnesota",253117,125629,127488,15405,17863,18228,17564,15129,28266,32715,37619,18641,16268,20966,9650,4803,39.1,190176,181869,45254,35419,190176,93069,97107,35419,16170,19249
0500000US27171,"Wright County, Minnesota",132550,66963,65587,8947,10333,11024,10017,7045,15221,18421,19045,9481,7000,9765,4492,1759,36.6,95155,91092,20192,16016,95155,47811,47344,16016,7655,8361
0500000US28033,"DeSoto County, Mississippi",175611,85225,90386,10303,12800,13919,13866,10386,21453,26930,23944,10088,10359,13128,6873,1562,37.2,129710,122286,28950,21563,129710,61500,68210,21563,9425,12138
0500000US28035,"Forrest County, Mississippi",75979,35478,40501,4892,5060,5143,5809,8023,11359,8985,8390,3956,4488,5201,2961,1712,31.9,58558,53787,12812,9874,58558,27106,31452,9874,4031,5843
0500000US28047,"Harrison County, Mississippi",203234,99744,103490,14031,13325,13784,13499,15241,29790,24847,25499,12093,13493,16613,8265,2754,35.6,154194,145972,35453,27632,154194,74824,79370,27632,12563,15069
0500000US28049,"Hinds County, Mississippi",241229,112687,128542,15806,16877,16236,18342,19275,35590,29159,28732,15126,14807,18416,9031,3832,34.4,181948,169342,40687,31279,181948,82595,99353,31279,12741,18538
0500000US28059,"Jackson County, Mississippi",141241,67681,73560,7694,9103,10562,11483,8203,17799,17167,20053,10388,8124,12658,5565,2442,38,107142,100637,25751,20665,107142,51214,55928,20665,9341,11324
0500000US28067,"Jones County, Mississippi",67953,32765,35188,4637,4570,5519,3762,4581,9129,8411,7762,4646,4061,6346,3099,1430,36.8,50577,48378,13322,10875,50577,23857,26720,10875,4773,6102
0500000US28075,"Lauderdale County, Mississippi",77755,38539,39216,4803,6187,5166,4848,5174,9299,11177,8477,4786,5195,7340,3566,1737,37.8,58729,55491,14793,12643,58729,27938,30791,12643,5348,7295
0500000US28081,"Lee County, Mississippi",85381,41057,44324,5840,6489,5482,5727,4950,11322,11252,11191,6091,4590,7204,4313,930,38.3,63559,60878,15295,12447,63559,29661,33898,12447,5087,7360
0500000US28089,"Madison County, Mississippi",105114,50550,54564,6949,7067,7832,8229,6426,13266,14573,13975,6540,6639,8313,3607,1698,37.6,78632,74079,17552,13618,78632,36484,42148,13618,5821,7797
0500000US28121,"Rankin County, Mississippi",150228,72542,77686,9203,8362,11766,9477,9277,22025,20122,20544,10763,7742,12519,6462,1966,37.1,114257,109941,25030,20947,114257,54263,59994,20947,8849,12098
0500000US29019,"Boone County, Missouri",176594,86362,90232,10462,8795,11093,14918,25466,27430,19897,19265,10290,8410,12307,6713,1548,30.6,140657,128208,25179,20568,140657,67533,73124,20568,9055,11513
0500000US29021,"Buchanan County, Missouri",88938,45511,43427,5548,6119,5567,5337,5455,12723,10969,12156,6029,5311,7862,4250,1612,37.9,68860,65343,16747,13724,68860,34934,33926,13724,5897,7827
0500000US29031,"Cape Girardeau County, Missouri",78913,38137,40776,4719,5541,4361,5272,7978,10523,8733,9179,5357,4615,6853,3986,1796,36,61953,56378,15125,12635,61953,29623,32330,12635,5467,7168
0500000US29037,"Cass County, Missouri",102845,49757,53088,6247,7034,7396,6974,5464,11934,12752,14566,6794,6974,9640,4632,2438,40,77728,74003,20361,16710,77728,37467,40261,16710,7311,9399
0500000US29043,"Christian County, Missouri",84401,41057,43344,5465,6920,5756,5358,4548,10631,11868,10807,5498,4736,7911,3977,926,37.3,62528,60248,15623,12814,62528,29805,32723,12814,6012,6802
0500000US29047,"Clay County, Missouri",239085,117726,121359,14985,19033,14698,15067,14393,31584,33901,33705,15092,14200,19765,8177,4485,37.4,180465,172066,40615,32427,180465,87373,93092,32427,14719,17708
0500000US29051,"Cole County, Missouri",76631,38876,37755,3939,5400,5361,6408,3636,9441,10071,10591,4748,5346,6954,3458,1278,39.2,59202,54892,14746,11690,59202,29971,29231,11690,5205,6485
0500000US29071,"Franklin County, Missouri",102838,51683,51155,6592,5692,7429,6303,5838,12522,11504,14997,8829,6050,10120,4939,2023,40.9,78961,75276,20490,17082,78961,39129,39832,17082,7875,9207
0500000US29077,"Greene County, Missouri",288690,141178,147512,16703,16318,17400,20604,30613,39318,32449,34622,18648,16167,25231,14893,5724,36,228354,211335,56231,45848,228354,109830,118524,45848,19382,26466
0500000US29095,"Jackson County, Missouri",691801,334478,357323,46803,43159,48697,42441,42967,106356,85653,88799,48272,41331,55870,28042,13411,36.5,525993,502231,120974,97323,525993,250241,275752,97323,40994,56329
0500000US29097,"Jasper County, Missouri",119111,57629,61482,8150,8530,8539,8409,7890,15829,15560,14928,8330,5829,9904,5263,1950,36.3,89116,83995,20358,17117,89116,42822,46294,17117,7509,9608
0500000US29099,"Jefferson County, Missouri",224226,111045,113181,13005,16156,14849,13958,11896,28119,29678,32854,17074,14800,19946,8991,2900,39.3,170954,163437,39644,31837,170954,84007,86947,31837,14418,17419
0500000US29165,"Platte County, Missouri",98309,48678,49631,5869,6146,6712,6720,6452,11996,13777,14570,7188,5320,8580,3491,1488,38.3,74864,70875,16220,13559,74864,36691,38173,13559,6204,7355
0500000US29183,"St. Charles County, Missouri",390918,191755,199163,23805,26588,26703,25773,23945,50893,52993,53077,29168,22514,32707,16636,6116,38,297669,282076,68362,55459,297669,144939,152730,55459,24729,30730
0500000US29187,"St. Francois County, Missouri",66627,36256,30371,3330,4383,3531,4656,3825,9576,8992,8878,4348,4397,6254,3486,971,39.7,52678,49530,12673,10711,52678,29365,23313,10711,4973,5738
0500000US29189,"St. Louis County, Missouri",998581,474218,524363,58297,58486,64572,64517,62101,127221,117454,131692,72424,69457,94818,48994,28548,40.3,776918,740206,212288,172360,776918,360839,416079,172360,71738,100622
0500000US29510,"St. Louis city, Missouri",311404,150976,160428,19951,16930,15588,16998,23002,61779,40790,37989,19456,22283,21524,10388,4726,35.3,249750,237741,48041,36638,249750,119236,130514,36638,15081,21557
0500000US30013,"Cascade County, Montana",81755,41495,40260,5342,4901,5243,4545,6268,11496,8879,9189,5382,5631,8357,4523,1999,38.6,63442,61014,18363,14879,63442,32079,31363,14879,7092,7787
0500000US30029,"Flathead County, Montana",98082,48402,49680,5841,6700,5706,5836,4736,11580,11939,12048,7382,8719,10824,4818,1953,42.3,76262,73015,23123,17595,76262,37250,39012,17595,8548,9047
0500000US30031,"Gallatin County, Montana",104502,54254,50248,5786,5464,6575,7557,12608,16469,13957,11573,5479,6505,7838,3160,1531,33.7,83226,76650,15741,12529,83226,43115,40111,12529,5856,6673
0500000US30049,"Lewis and Clark County, Montana",67282,32723,34559,3519,4415,4166,4387,3658,7810,8061,9053,4965,5201,7500,3174,1373,41.6,52509,49347,16122,12047,52509,25161,27348,12047,5537,6510
0500000US30063,"Missoula County, Montana",116130,59269,56861,5657,6732,5905,7476,12428,17524,14583,14666,7957,6479,10379,4917,1427,36.4,94087,87777,20113,16723,94087,47650,46437,16723,8071,8652
0500000US30111,"Yellowstone County, Montana",158437,78855,79582,10500,10415,10531,9287,10069,20271,18945,20632,12518,9645,14547,7187,3890,38.9,120983,116124,31912,25624,120983,58782,62201,25624,11339,14285
0500000US31055,"Douglas County, Nebraska",554995,274299,280696,42394,39837,38062,37607,36791,87096,72324,68263,34781,30312,40154,18759,8615,34.5,411633,389273,84928,67528,411633,200666,210967,67528,29269,38259
0500000US31109,"Lancaster County, Nebraska",309637,155106,154531,20320,19428,20591,22880,34580,45326,36840,33650,19726,16222,23825,10520,5729,33.1,238396,218918,49072,40074,238396,119061,119335,40074,18111,21963
0500000US31153,"Sarpy County, Nebraska",179023,89675,89348,13277,14926,13644,11637,11691,25118,25107,24307,10611,8807,11790,6465,1643,34.7,129334,123751,24625,19898,129334,64115,65219,19898,8662,11236
0500000US32003,"Clark County, Nevada",2155664,1076144,1079520,138602,143042,141116,130839,137659,320855,298072,289972,129489,122371,189191,87657,26799,37,1648780,1573965,374876,303647,1648780,816774,832006,303647,141667,161980
0500000US32031,"Washoe County, Nevada",453616,228410,225206,27309,27035,28807,27676,30441,66885,54217,59919,29163,31010,45907,19052,6195,38.2,353948,335496,88881,71154,353948,176596,177352,71154,33794,37360
0500000US33005,"Cheshire County, New Hampshire",75774,37376,38398,3577,4119,3498,6288,5525,8793,7781,10143,6487,5609,8308,3519,2127,42.9,62168,56719,17380,13954,62168,30366,31802,13954,6471,7483
0500000US33009,"Grafton County, New Hampshire",88888,43711,45177,3828,4239,3630,7513,6475,11036,9019,11590,6900,7068,10159,4331,3100,43.1,74232,68549,21786,17590,74232,36594,37638,17590,8246,9344
0500000US33011,"Hillsborough County, New Hampshire",407761,203705,204056,21589,24577,23777,25938,25516,53963,49508,63615,31832,26592,35387,17105,8362,40.4,322224,306449,76414,60854,322224,158249,163975,60854,26889,33965
0500000US33013,"Merrimack County, New Hampshire",148582,73820,74762,7090,9279,7208,9293,10134,17643,17441,21766,12269,10403,15318,6268,4470,42.4,119729,113124,32309,26056,119729,58941,60788,26056,11692,14364
0500000US33015,"Rockingham County, New Hampshire",303251,150446,152805,13714,16871,17744,17949,17128,34032,35482,50814,27754,21702,30773,13449,5839,44.6,242952,233756,63113,50061,242952,119474,123478,50061,22657,27404
0500000US33017,"Strafford County, New Hampshire",127428,62491,64937,6210,6248,7399,10031,14475,16056,14133,17899,8245,8631,10682,6131,1288,36.9,103399,93916,22768,18101,103399,49910,53489,18101,8171,9930
0500000US34001,"Atlantic County, New Jersey",270991,131134,139857,15660,14749,17990,16713,19236,31954,31296,38367,22060,17176,26968,13461,5361,40.6,212029,200873,55438,45790,212029,101007,111022,45790,20160,25630
0500000US34003,"Bergen County, New Jersey",939151,455140,484011,49531,57804,56385,58561,56082,109676,123746,142417,68685,61522,84265,44537,25940,41.4,737850,707089,189660,154742,737850,352387,385463,154742,66654,88088
0500000US34005,"Burlington County, New Jersey",449284,221357,227927,22890,24134,29988,27323,29560,55483,55008,67987,35293,28408,41088,21976,10146,41.5,354594,340563,89445,73210,354594,173382,181212,73210,31468,41742
0500000US34007,"Camden County, New Jersey",510150,247142,263008,31441,32794,32725,31593,32352,70864,63822,70715,38761,28965,44426,20619,11073,38.5,392754,376600,92691,76118,392754,186498,206256,76118,32281,43837
0500000US34009,"Cape May County, New Jersey",94430,46576,47854,3949,4660,5188,4386,5760,9096,9161,12935,6428,8609,14290,6461,3507,49,77788,74945,29675,24258,77788,37578,40210,24258,10906,13352
0500000US34011,"Cumberland County, New Jersey",153797,78770,75027,9956,10005,10752,9894,8768,22685,20391,20488,10552,7872,13124,6876,2434,36.8,117171,111063,26607,22434,117171,59895,57276,22434,9688,12746
0500000US34013,"Essex County, New Jersey",796914,383430,413484,52115,53070,52976,51408,53289,109390,111751,113776,51804,44765,59292,28468,14810,37.2,607422,576136,127728,102570,607422,286879,320543,102570,41737,60833
0500000US34015,"Gloucester County, New Jersey",292330,141848,150482,15926,19528,17592,20127,18524,36434,36587,43105,21787,18872,26694,11107,6047,39.7,226838,214895,53779,43848,226838,108364,118474,43848,18799,25049
0500000US34017,"Hudson County, New Jersey",677983,337305,340678,46729,38595,32922,33096,44475,144220,106604,85014,37742,34266,43007,22861,8452,34.9,539385,519313,92315,74320,539385,266528,272857,74320,30661,43659
0500000US34019,"Hunterdon County, New Jersey",124676,62582,62094,5107,5697,8037,9636,8017,11092,12923,21634,11482,10218,12342,6227,2264,46.2,99421,95333,27052,20833,99421,49161,50260,20833,9631,11202
0500000US34021,"Mercer County, New Jersey",371023,181379,189644,21000,21129,23178,27212,28726,47379,47642,53106,26239,22197,30446,14103,8666,38.5,291406,272087,65897,53215,291406,141013,150393,53215,22535,30680
0500000US34023,"Middlesex County, New Jersey",837073,412318,424755,48674,53442,48310,55696,55952,117109,114720,117275,57361,49996,67755,33528,17255,38.2,654887,615359,145761,118538,654887,319331,335556,118538,51227,67311
0500000US34025,"Monmouth County, New Jersey",625846,304738,321108,30977,37952,39786,41781,38423,66870,72065,99119,53081,42031,59770,29537,14454,43,490452,469149,128494,103761,490452,235900,254552,103761,44911,58850
0500000US34027,"Morris County, New Jersey",498423,244273,254150,24511,28633,33390,34544,30179,53096,62351,80246,37312,33591,45364,22819,12387,42.4,390254,372307,99927,80570,390254,188955,201299,80570,35352,45218
0500000US34029,"Ocean County, New Jersey",592497,285718,306779,40520,39638,37786,35076,31313,64502,60206,73545,39216,38848,70516,40963,20368,42.8,452297,433031,155305,131847,452297,213902,238395,131847,55511,76336
0500000US34031,"Passaic County, New Jersey",507945,247924,260021,34618,35283,32449,35332,35865,67844,65070,69381,31007,31667,40153,18849,10427,36.7,384901,362915,87990,69429,384901,184785,200116,69429,29389,40040
0500000US34033,"Salem County, New Jersey",63436,31035,32401,3520,4232,3597,4209,3943,6888,7468,8726,5443,3994,6548,3317,1551,41.2,49610,47390,13829,11416,49610,23942,25668,11416,5108,6308
0500000US34035,"Somerset County, New Jersey",333751,162691,171060,17182,19802,23325,22123,21052,34171,44685,54446,27715,19632,27877,14052,7689,41.5,258729,248206,59597,49618,258729,124431,134298,49618,21264,28354
0500000US34037,"Sussex County, New Jersey",142522,71095,71427,6025,7357,9371,10235,7923,14511,16278,24407,13537,10354,14268,6330,1926,44.7,113197,107927,27698,22524,113197,55884,57313,22524,10536,11988
0500000US34039,"Union County, New Jersey",555630,271004,284626,34699,36726,37313,36309,34629,71809,76937,81114,37052,33696,42881,21146,11319,38.5,424330,403533,95320,75346,424330,204264,220066,75346,31522,43824
0500000US34041,"Warren County, New Jersey",106617,52752,53865,5140,5511,6889,6663,6452,11989,12677,16703,10657,6168,10072,4999,2697,44.1,84715,80217,21192,17768,84715,41295,43420,17768,7665,10103
0500000US35001,"Bernalillo County, New Mexico",676953,331988,344965,39840,43207,42518,42860,45381,101234,84789,85768,45000,43345,61659,29906,11446,37.4,525146,498612,129166,103011,525146,254459,270687,103011,45384,57627
0500000US35005,"Chaves County, New Mexico",65282,33230,32052,4448,5248,4567,6189,3960,8156,7895,7028,4517,3480,4924,3622,1248,35.1,47453,44064,11872,9794,47453,23493,23960,9794,4404,5390
0500000US35013,"Doña Ana County, New Mexico",214207,105526,108681,14016,14494,15945,16216,23379,27641,22642,22893,12694,11824,18705,9941,3817,33.5,160740,149939,39377,32463,160740,78512,82228,32463,15073,17390
0500000US35025,"Lea County, New Mexico",69749,35234,34515,5537,6315,5910,6103,4123,10243,9260,7689,3523,3776,4103,2473,694,31.5,48500,45132,9624,7270,48500,24582,23918,7270,3297,3973
0500000US35031,"McKinley County, New Mexico",74923,35991,38932,5797,6711,5782,6685,5350,10136,9110,8943,4374,3694,5163,2447,731,31.6,52437,48476,10500,8341,52437,24101,28336,8341,3060,5281
0500000US35035,"Otero County, New Mexico",65410,33001,32409,4554,4820,3361,5290,4138,9552,7346,7667,3977,3743,6143,4019,800,35.8,49970,46633,13345,10962,49970,26054,23916,10962,5355,5607
0500000US35043,"Sandoval County, New Mexico",142025,69889,72136,7623,9341,10457,10768,6481,18257,17852,18387,10807,8802,14880,6238,2132,38.8,108062,102503,28810,23250,108062,51919,56143,23250,10765,12485
0500000US35045,"San Juan County, New Mexico",115079,56584,58495,7994,8490,8257,7274,7336,15629,14344,13411,8344,6639,10228,5005,2128,36.3,85384,81701,21256,17361,85384,42202,43182,17361,7803,9558
0500000US35049,"Santa Fe County, New Mexico",148651,72532,76119,6663,7164,8881,8751,7555,17070,16522,18989,11926,12189,21235,8055,3651,46,120872,114828,40360,32941,120872,58307,62565,32941,15084,17857
0500000US35061,"Valencia County, New Mexico",75626,38367,37259,4298,5574,5158,4907,4319,9452,9288,9720,5342,5016,7637,3494,1421,38.3,57383,54736,15199,12552,57383,28824,28559,12552,5991,6561
0500000US36001,"Albany County, New York",308846,150008,158838,15596,15589,15991,23349,33508,39492,35494,39868,21843,19270,27602,12582,8662,37.9,251050,231198,59096,48846,251050,119927,131123,48846,20862,27984
0500000US36005,"Bronx County, New York",1455720,686382,769338,107412,105750,94881,101467,114941,231644,184048,188735,82289,73572,97198,52450,21333,33.6,1087399,1021808,211831,170981,1087399,498570,588829,170981,66446,104535
0500000US36007,"Broome County, New York",195334,95998,99336,9929,10748,10399,15801,18263,22595,19602,25194,13644,13674,18640,10632,6213,39.6,156805,143386,43153,35485,156805,75699,81106,35485,15222,20263
0500000US36009,"Cattaraugus County, New York",77677,38420,39257,4762,4952,4843,5356,5151,8418,8330,10078,6150,5761,8101,3975,1800,41.6,60081,56363,17280,13876,60081,29594,30487,13876,6455,7421
0500000US36011,"Cayuga County, New York",77861,40044,37817,3771,3789,4726,5459,5486,9325,8675,11024,6503,5513,7816,3431,2343,41.4,62429,59047,16955,13590,62429,32284,30145,13590,6289,7301
0500000US36013,"Chautauqua County, New York",129504,63937,65567,7163,6584,8030,9527,8694,15924,13022,16472,10578,9065,13666,7850,2929,42.2,102807,96072,29966,24445,102807,50450,52357,24445,10942,13503
0500000US36015,"Chemung County, New York",86322,43024,43298,4774,4844,5148,5866,5402,10127,10537,11454,6349,6106,9205,4045,2465,41.5,67998,64153,19450,15715,67998,33881,34117,15715,6904,8811
0500000US36019,"Clinton County, New York",81073,41503,39570,3653,3814,3904,6354,7420,10674,9015,11292,6478,5293,7705,3946,1525,39.2,67299,61784,16015,13176,67299,34503,32796,13176,5998,7178
0500000US36027,"Dutchess County, New York",294473,145770,148703,12777,16103,16673,23037,21969,33868,32790,45357,23308,20412,28012,14709,5458,41.8,237399,221423,60283,48179,237399,117434,119965,48179,21311,26868
0500000US36029,"Erie County, New York",921046,446090,474956,50068,51196,52813,59342,63718,129214,101335,124300,64748,66926,86528,46891,23967,40,732128,694198,195813,157386,732128,349855,382273,157386,66780,90606
0500000US36045,"Jefferson County, New York",114006,59129,54877,8874,7497,7075,6967,11470,18802,12676,13534,5826,6289,8792,4214,1990,33.1,86512,82202,18884,14996,86512,45748,40764,14996,6773,8223
0500000US36047,"Kings County, New York",2629150,1247152,1381998,194313,171648,151580,145070,175001,483666,365561,317714,148949,141963,190272,95936,47477,34.8,2019764,1938014,415126,333685,2019764,935615,1084149,333685,135690,197995
0500000US36051,"Livingston County, New York",64257,32140,32117,2607,2836,3571,5582,7156,6744,6646,9062,5245,3993,6331,3017,1467,40.7,53030,47373,12974,10815,53030,26236,26794,10815,4969,5846
0500000US36053,"Madison County, New York",71329,35319,36010,3270,3737,3880,6154,6324,7597,7465,10305,5548,5081,7060,3289,1619,41.3,57737,52928,14915,11968,57737,28472,29265,11968,5500,6468
0500000US36055,"Monroe County, New York",747727,361383,386344,41381,42940,45197,51595,54274,103865,83295,100761,54585,47208,69352,35198,18076,38.7,589826,555158,150895,122626,589826,280658,309168,122626,52688,69938
0500000US36059,"Nassau County, New York",1361500,661023,700477,73510,82824,84088,89945,88815,155840,162437,200043,104454,87778,126348,64070,41348,41.5,1065346,1013387,280320,231766,1065346,509126,556220,231766,99697,132069
0500000US36061,"New York County, New York",1643734,779699,864035,80875,64338,60739,70460,116521,372335,239181,206975,93101,93586,137042,68674,39907,37.1,1402998,1349715,301578,245623,1402998,658180,744818,245623,99865,145758
0500000US36063,"Niagara County, New York",211758,103889,107869,10750,10343,13455,14033,12277,25309,24019,30446,16145,16634,21911,11544,4892,43.4,168939,160823,48056,38347,168939,81318,87621,38347,16767,21580
0500000US36065,"Oneida County, New York",231190,114737,116453,13122,15545,12267,15218,15485,28214,25030,32077,17771,14814,22782,12164,6701,41.1,182312,171824,50818,41647,182312,90004,92308,41647,18426,23221
0500000US36067,"Onondaga County, New York",466194,224766,241428,26196,28052,28421,35139,32100,61136,53055,62493,35206,29717,41788,20991,11900,38.7,365629,342376,91462,74679,365629,173626,192003,74679,32293,42386
0500000US36069,"Ontario County, New York",109828,53977,55851,5424,5301,7671,7221,6610,11868,11989,16386,7484,8846,12272,5319,3437,44.3,87346,82967,25643,21028,87346,42040,45306,21028,9462,11566
0500000US36071,"Orange County, New York",379210,189312,189898,24637,26608,28168,28970,29077,43854,45161,55025,25383,22323,30023,12855,7126,37.2,281973,263932,64364,50004,281973,139608,142365,50004,22105,27899
0500000US36075,"Oswego County, New York",118987,59716,59271,7113,6947,6437,9436,8815,14545,12524,17839,9683,7587,10990,5346,1725,40.1,93671,86955,22587,18061,93671,46804,46867,18061,8352,9709
0500000US36079,"Putnam County, New York",98900,48854,50046,3730,5193,6942,6484,5983,10169,12914,16590,7352,7751,9670,4696,1426,43.8,78650,75691,20316,15792,78650,38957,39693,15792,7359,8433
0500000US36081,"Queens County, New York",2333054,1131856,1201198,145309,129432,125982,121760,149292,381573,325901,324626,154703,141926,187034,97528,47988,38.3,1856645,1779634,413869,332550,1856645,887819,968826,332550,139079,193471
0500000US36083,"Rensselaer County, New York",160070,78869,81201,8625,8842,9213,11149,11492,22217,18065,22256,13291,9634,15112,6468,3706,39.5,128097,119196,30949,25286,128097,62901,65196,25286,11215,14071
0500000US36085,"Richmond County, New York",476015,230553,245462,26880,29466,29896,28454,31408,63666,60389,68126,33660,30939,43322,20831,8978,39.7,371113,354733,91446,73131,371113,176602,194511,73131,31284,41847
0500000US36087,"Rockland County, New York",326780,159480,167300,24985,26154,24295,24204,21952,36242,36934,42277,23244,16084,27883,13999,8527,36.5,236075,222721,59341,50409,236075,113621,122454,50409,21395,29014
0500000US36089,"St. Lawrence County, New York",110038,55511,54527,5689,5781,6987,9915,9504,13042,11583,14444,7447,7518,10373,5253,2502,38.8,87738,78373,22542,18128,87738,44272,43466,18128,8356,9772
0500000US36091,"Saratoga County, New York",227053,113487,113566,11541,14800,11310,14297,14920,27101,27958,35248,16461,15717,22890,9701,5109,42,180425,172346,45711,37700,180425,89608,90817,37700,16898,20802
0500000US36093,"Schenectady County, New York",154553,74263,80290,9178,10185,9234,9744,10383,19528,18322,21427,12138,9123,14208,6284,4799,40.1,120919,113924,30344,25291,120919,57710,63209,25291,10535,14756
0500000US36101,"Steuben County, New York",96940,48179,48761,5297,5449,6397,6033,5765,11026,11144,13472,7928,6806,10060,5861,1702,42.3,75787,72085,21602,17623,75787,37202,38585,17623,8030,9593
0500000US36103,"Suffolk County, New York",1492583,734100,758483,78480,86050,95962,101194,99821,171566,178774,233661,106994,100481,136136,70155,33309,41.2,1169450,1110485,295580,239600,1169450,569045,600405,239600,104109,135491
0500000US36105,"Sullivan County, New York",74801,38420,36381,4077,3747,4979,5721,4781,7436,7563,12012,5193,5643,8615,3500,1534,43.8,58742,55126,16614,13649,58742,29980,28762,13649,6540,7109
0500000US36109,"Tompkins County, New York",104871,51667,53204,4259,4898,3966,12216,18928,13780,10383,11048,6162,5814,8223,3290,1904,30.6,89266,72780,16592,13417,89266,43157,46109,13417,6078,7339
0500000US36111,"Ulster County, New York",179225,89419,89806,7623,9801,9552,11034,11925,21402,19763,27405,15782,11723,19824,9014,4377,44.1,146445,138467,39937,33215,146445,72714,73731,33215,14965,18250
0500000US36113,"Warren County, New York",64567,31800,32767,3114,2385,4178,3366,3515,7940,6582,9470,5536,4867,7985,4035,1594,47.1,52651,51189,16859,13614,52651,25583,27068,13614,6322,7292
0500000US36117,"Wayne County, New York",90798,44497,46301,4550,6274,4970,5767,5067,9631,10359,14111,7292,6659,9680,4446,1992,43.6,71188,68627,19470,16118,71188,34678,36510,16118,7384,8734
0500000US36119,"Westchester County, New York",974542,471884,502658,54797,59924,63955,66708,62251,109889,124664,145137,67579,62031,84238,49318,24051,40.7,755239,716643,195507,157607,755239,358471,396768,157607,66166,91441
0500000US37001,"Alamance County, North Carolina",159688,76240,83448,9033,8078,12135,11478,10516,19163,19468,22270,10929,10047,14951,8286,3334,39.9,123999,116520,32797,26571,123999,58223,65776,26571,11227,15344
0500000US37019,"Brunswick County, North Carolina",126953,61148,65805,6464,5461,4855,5329,5098,12195,12303,14154,10591,12398,25654,9919,2532,53.4,106869,103311,46511,38105,106869,50786,56083,38105,18379,19726
0500000US37021,"Buncombe County, North Carolina",256088,123522,132566,11613,13641,14888,13945,14733,35093,33392,34048,16770,19301,28951,14265,5448,42.6,207535,199420,60887,48664,207535,97868,109667,48664,21202,27462
0500000US37023,"Burke County, North Carolina",88851,44093,44758,3711,5413,4195,6033,5223,9993,9827,13859,5890,7012,10700,4612,2383,45,71646,68609,21413,17695,71646,35375,36271,17695,7688,10007
0500000US37025,"Cabarrus County, North Carolina",201590,97770,103820,12584,13804,16977,15036,10537,24777,28676,29687,13327,10233,16521,6983,2448,37.7,148871,140771,32948,25952,148871,71381,77490,25952,11535,14417
0500000US37027,"Caldwell County, North Carolina",81449,40169,41280,3901,4331,5360,4635,4645,9637,10148,11811,6205,5524,9369,4651,1232,43.3,65097,61784,18533,15252,65097,31913,33184,15252,6841,8411
0500000US37031,"Carteret County, North Carolina",68890,33599,35291,3169,4202,3025,3856,2858,7191,7861,9268,5098,6028,10213,4491,1630,48,56366,54388,20115,16334,56366,26968,29398,16334,7522,8812
0500000US37035,"Catawba County, North Carolina",156459,77838,78621,9036,8942,10639,10329,9080,17317,20163,23043,11367,9289,16771,8489,1994,41.3,121175,116195,32594,27254,121175,58623,62552,27254,12435,14819
0500000US37037,"Chatham County, North Carolina",72243,34139,38104,2780,4149,5153,4479,2698,6196,8537,10043,5139,5147,10242,4591,3089,47.1,57351,55106,20496,17922,57351,26710,30641,17922,7713,10209
0500000US37045,"Cleveland County, North Carolina",97144,47494,49650,5630,6766,5194,6183,7655,10283,11426,13414,7022,6232,10418,4917,2004,40.7,75642,71551,21346,17339,75642,35774,39868,17339,7569,9770
0500000US37049,"Craven County, North Carolina",103445,52824,50621,6463,7051,6067,6955,9222,12978,11366,11274,5507,7502,10953,5840,2267,37.4,80833,74651,24479,19060,80833,40829,40004,19060,8522,10538
0500000US37051,"Cumberland County, North Carolina",327127,160604,166523,25328,23825,20678,22946,30543,55003,38761,37390,19213,15728,22388,11026,4298,32,244080,228473,45738,37712,244080,117985,126095,37712,15988,21724
0500000US37057,"Davidson County, North Carolina",164926,79467,85459,8761,10834,9691,11623,8841,18632,19451,24936,13320,9403,17234,9154,3046,42.3,128011,122017,34755,29434,128011,61410,66601,29434,12965,16469
0500000US37063,"Durham County, North Carolina",306212,146455,159757,20527,18607,17233,16094,23806,56190,42602,38923,18854,16584,22550,9578,4664,35.1,240061,229984,46663,36792,240061,112588,127473,36792,15625,21167
0500000US37067,"Forsyth County, North Carolina",371511,176789,194722,22663,25318,24236,26393,25059,47580,45237,50660,25536,23112,32429,17479,5809,38,284168,267390,68334,55717,284168,131994,152174,55717,23514,32203
0500000US37071,"Gaston County, North Carolina",216965,104655,112310,13247,13324,14129,14422,12585,27358,27722,31942,13004,15340,20791,9104,3997,39.8,167454,160158,43371,33892,167454,79557,87897,33892,14462,19430
0500000US37081,"Guilford County, North Carolina",521330,246962,274368,30834,33215,33531,38010,37933,71413,65043,71396,34161,30264,44193,22436,8901,37.1,403168,376914,93346,75530,403168,187116,216052,75530,32200,43330
0500000US37085,"Harnett County, North Carolina",130881,65600,65281,9899,9860,9804,9072,8119,20687,17485,16725,6619,7233,9423,4333,1622,34,95815,90416,19588,15378,95815,47112,48703,15378,6660,8718
0500000US37089,"Henderson County, North Carolina",114209,54745,59464,5375,6022,6482,6119,4923,11058,13130,15403,7843,8666,16665,8935,3588,47.3,92374,88247,34157,29188,92374,43316,49058,29188,12951,16237
0500000US37097,"Iredell County, North Carolina",172916,85047,87869,9795,10240,12943,12609,9801,19343,22454,26894,12943,9706,15936,7244,3008,40.8,132294,125350,31840,26188,132294,64423,67871,26188,11557,14631
0500000US37101,"Johnston County, North Carolina",191450,94352,97098,12168,11043,17719,14176,10938,21358,26890,29548,12773,10716,14785,6204,3132,38,141458,134556,30888,24121,141458,68247,73211,24121,10522,13599
0500000US37109,"Lincoln County, North Carolina",81168,39677,41491,3906,4503,5769,4660,4099,8624,10222,14294,6279,5520,8250,3999,1043,44.3,63988,61953,16227,13292,63988,31187,32801,13292,5939,7353
0500000US37119,"Mecklenburg County, North Carolina",1054835,506610,548225,71902,71757,70261,67510,69220,176519,156976,144832,59261,55155,68474,31647,11321,35,799784,762495,142567,111442,799784,377751,422033,111442,46289,65153
0500000US37125,"Moore County, North Carolina",95776,45342,50434,4950,5966,5183,7314,3203,10520,10407,12012,6317,6639,12393,7190,3682,45.4,75683,71248,27768,23265,75683,35520,40163,23265,10601,12664
0500000US37127,"Nash County, North Carolina",94005,46638,47367,4711,6449,4894,5794,5795,12102,10854,13638,6796,6383,10148,4507,1934,41.8,73799,71526,19936,16589,73799,35669,38130,16589,7266,9323
0500000US37129,"New Hanover County, North Carolina",223483,106521,116962,11108,11848,12018,15417,20444,29352,28274,28861,15046,13766,23227,9760,4362,39.1,181266,169632,44701,37349,181266,85010,96256,37349,15982,21367
0500000US37133,"Onslow County, North Carolina",187136,101034,86102,17625,12893,11415,13540,30929,33173,20270,14844,8166,6968,10228,6266,819,26.6,139605,124488,21156,17313,139605,76936,62669,17313,7928,9385
0500000US37135,"Orange County, North Carolina",141796,67401,74395,6909,7861,8909,10962,19380,17928,16087,19212,8824,8395,10759,4114,2456,34.1,113056,102757,22683,17329,113056,52812,60244,17329,7638,9691
0500000US37147,"Pitt County, North Carolina",177220,83449,93771,10004,12962,9083,18392,20391,24692,20731,20715,11071,8392,12761,6767,1259,32.1,138482,121903,25006,20787,138482,63120,75362,20787,8888,11899
0500000US37151,"Randolph County, North Carolina",143416,70702,72714,7956,8464,10011,9475,8004,16222,16923,21931,11235,8741,14866,7062,2526,42.6,110495,105935,30380,24454,110495,53609,56886,24454,10955,13499
0500000US37155,"Robeson County, North Carolina",133235,63685,69550,8952,9543,9792,9430,9934,17000,16332,16897,8168,8549,11959,5015,1664,36.3,99047,93005,23989,18638,99047,46583,52464,18638,7939,10699
0500000US37157,"Rockingham County, North Carolina",91393,44333,47060,4062,6354,5411,5649,5010,9310,11242,12818,7292,6678,9623,6292,1652,43.7,72517,68551,21635,17567,72517,34413,38104,17567,7618,9949
0500000US37159,"Rowan County, North Carolina",139933,68758,71175,7397,8916,8930,10945,7855,16648,17349,18962,10513,8989,13811,6805,2813,39.4,108409,102144,28159,23429,108409,52889,55520,23429,10291,13138
0500000US37161,"Rutherford County, North Carolina",66421,32104,34317,2624,3140,3753,5904,3752,6285,7210,9384,5170,5022,8282,4118,1777,45.6,52909,49821,16840,14177,52909,24999,27910,14177,6039,8138
0500000US37171,"Surry County, North Carolina",72113,35755,36358,3398,4689,4285,4836,3861,7098,8590,11139,5322,4329,8524,3844,2198,44.3,56712,53826,17039,14566,56712,27485,29227,14566,6346,8220
0500000US37179,"Union County, North Carolina",226606,110942,115664,13264,16620,20783,19185,12765,21288,32574,37076,15430,10461,17031,7670,2459,38.4,163746,154529,33387,27160,163746,79169,84577,27160,12065,15095
0500000US37183,"Wake County, North Carolina",1046791,508628,538163,66352,74308,72706,72868,67119,153563,158514,152557,65990,51165,69020,30098,12531,36,790037,746632,142631,111649,790037,378511,411526,111649,47912,63737
0500000US37191,"Wayne County, North Carolina",124150,60609,63541,8384,8743,7520,8961,8044,16923,14585,16464,7687,8182,11137,5680,1840,37.3,94288,88755,23470,18657,94288,45406,48882,18657,7940,10717
0500000US37193,"Wilkes County, North Carolina",68740,33877,34863,3145,4126,3863,4597,4063,7106,7948,10020,4514,5572,7966,4264,1556,44.2,54378,52465,17222,13786,54378,26392,27986,13786,6158,7628
0500000US37195,"Wilson County, North Carolina",81661,38874,42787,4668,5372,5653,6368,4269,9691,9912,10562,5022,6293,8123,4579,1149,40.3,62499,58897,17256,13851,62499,28863,33636,13851,5860,7991
0500000US38015,"Burleigh County, North Dakota",94487,46686,47801,6507,7075,5241,6095,6368,13887,11737,11378,6478,5667,7871,3555,2628,36.5,72183,68678,17153,14054,72183,35512,36671,14054,6116,7938
0500000US38017,"Cass County, North Dakota",175249,90877,84372,13707,11879,8872,10758,20301,30530,21065,19725,9343,9629,10973,5707,2760,32.4,136017,126664,24908,19440,136017,69702,66315,19440,8707,10733
0500000US38035,"Grand Forks County, North Dakota",71083,36679,34404,4822,3412,3786,5830,10982,12020,7081,6968,3892,3800,4636,2707,1147,29.9,56973,50763,11047,8490,56973,29081,27892,8490,3737,4753
0500000US38101,"Ward County, North Dakota",70210,37182,33028,5491,5371,3245,4270,7842,13299,8203,6979,3956,3233,4419,2825,1077,30.7,54042,50472,10607,8321,54042,28474,25568,8321,3569,4752
0500000US39003,"Allen County, Ohio",103742,51453,52289,6301,7034,6391,6504,9097,12737,11831,12608,6811,7257,9520,5207,2444,38.2,79825,75495,21576,17171,79825,39975,39850,17171,7580,9591
0500000US39007,"Ashtabula County, Ohio",98231,49800,48431,5307,7658,4933,6134,5210,10904,10998,13878,6341,8615,10343,6164,1746,43.4,76325,72913,23332,18253,76325,38497,37828,18253,8271,9982
0500000US39009,"Athens County, Ohio",66186,32687,33499,2606,2800,2431,9946,12520,7575,6277,7152,3413,3844,4609,2027,986,27.9,56590,44357,9504,7622,56590,27894,28696,7622,3317,4305
0500000US39013,"Belmont County, Ohio",68673,35233,33440,3335,3915,3298,3792,3594,8677,8263,9438,5689,5073,7501,4243,1855,44.5,55600,54029,16793,13599,55600,28468,27132,13599,6056,7543
0500000US39017,"Butler County, Ohio",377537,185576,191961,23254,25384,25938,28943,32249,44829,46036,49305,25923,22873,31477,15531,5795,36.5,288056,267264,65551,52803,288056,139383,148673,52803,23098,29705
0500000US39023,"Clark County, Ohio",134786,64502,70284,8172,8491,8294,8782,8803,15725,14257,17821,10217,8977,14143,7718,3386,41.9,104305,99600,30138,25247,104305,49564,54741,25247,11182,14065
0500000US39025,"Clermont County, Ohio",203022,100441,102581,11495,14788,12879,12549,12305,24869,25629,28584,14764,14458,18858,8277,3567,39.7,155584,149226,38415,30702,155584,76179,79405,30702,14059,16643
0500000US39029,"Columbiana County, Ohio",103685,52716,50969,5247,6127,5921,6249,5484,11415,12725,14227,7318,9133,11325,6003,2511,44.2,82425,79074,25394,19839,82425,41673,40752,19839,8868,10971
0500000US39035,"Cuyahoga County, Ohio",1249352,595362,653990,72795,72083,72212,78617,82301,169697,142613,164316,94601,85526,116842,63283,34466,40.2,984706,938420,264434,214591,984706,460792,523914,214591,89198,125393
0500000US39041,"Delaware County, Ohio",196463,97536,98927,12160,16787,14742,14171,10571,20368,29040,30186,12538,11559,15159,7309,1873,38.1,143329,136574,30604,24341,143329,70232,73097,24341,10835,13506
0500000US39043,"Erie County, Ohio",75107,36681,38426,3633,3812,4752,5002,4242,7914,7418,10354,4581,7202,9611,4769,1817,46.2,59756,57362,20079,16197,59756,28735,31021,16197,7286,8911
0500000US39045,"Fairfield County, Ohio",152597,76224,76373,9110,9384,11774,10318,8509,18065,19524,22611,10142,10253,13431,7187,2289,40.2,115362,110340,28817,22907,115362,57006,58356,22907,10220,12687
0500000US39049,"Franklin County, Ohio",1264518,617615,646903,92005,80951,79041,79322,91300,229437,167912,156785,77741,66645,86749,38302,18328,34,966845,913942,181933,143379,966845,466322,500523,143379,60608,82771
0500000US39055,"Geauga County, Ohio",94060,46402,47658,4796,5659,6825,6647,5800,7853,9515,13875,8195,6996,10476,5657,1766,44.9,72486,68691,22249,17899,72486,35416,37070,17899,8061,9838
0500000US39057,"Greene County, Ohio",164765,80408,84357,9434,8041,10662,12300,14484,22016,18360,19836,10376,12449,15785,7795,3227,38.6,130639,120224,33740,26807,130639,63656,66983,26807,11897,14910
0500000US39061,"Hamilton County, Ohio",809099,390081,419018,54085,53582,49500,53108,53228,121584,94038,103288,54511,53596,66317,34130,18132,37,621062,588630,149197,118579,621062,294687,326375,118579,49920,68659
0500000US39063,"Hancock County, Ohio",75872,37258,38614,4642,4070,5309,5373,4902,10480,8927,9427,5580,4597,7032,4100,1433,38.2,59002,55361,15073,12565,59002,29024,29978,12565,5515,7050
0500000US39081,"Jefferson County, Ohio",66704,32371,34333,3375,3795,3735,4245,4418,6911,7268,8981,5885,4795,7403,4185,1708,44.6,53280,50337,15982,13296,53280,25388,27892,13296,5784,7512
0500000US39085,"Lake County, Ohio",228614,110785,117829,11208,13394,12902,13508,12575,27340,25979,33510,20209,15345,23928,12877,5839,43.7,182224,175037,51355,42644,182224,87672,94552,42644,18123,24521
0500000US39089,"Licking County, Ohio",172198,84022,88176,10442,11008,12104,12040,10915,18993,20560,24363,12859,11341,16688,7901,2984,40,131241,124613,34286,27573,131241,62648,68593,27573,12226,15347
0500000US39093,"Lorain County, Ohio",306365,150841,155524,17823,18261,20202,20091,20021,32884,37703,42739,24053,19873,30626,14700,7389,41.3,237655,226631,64282,52715,237655,115833,121822,52715,23443,29272
0500000US39095,"Lucas County, Ohio",432488,209933,222555,27960,28605,26286,27611,29950,60371,50046,55861,31071,28234,38644,19832,8017,38,332773,316017,82405,66493,332773,159031,173742,66493,28518,37975
0500000US39099,"Mahoning County, Ohio",230008,112268,117740,11995,12731,13155,14258,13927,25908,26535,29948,17924,17703,24746,13528,7650,43.5,183303,174209,56262,45924,183303,88168,95135,45924,19630,26294
0500000US39101,"Marion County, Ohio",65096,34365,30731,3816,3516,3477,3922,4486,8473,8064,9279,4646,4416,6490,2909,1602,41.8,51460,49480,13325,11001,51460,27564,23896,11001,5030,5971
0500000US39103,"Medina County, Ohio",177221,87625,89596,9473,10983,12387,11578,9454,18739,22099,27274,14978,10854,17712,7899,3791,42.3,136598,130826,35415,29402,136598,66632,69966,29402,13463,15939
0500000US39109,"Miami County, Ohio",104679,51654,53025,5593,5863,8125,6793,5462,12265,12402,14264,7758,7299,10838,5107,2910,41.7,80503,77406,23356,18855,80503,38954,41549,18855,8206,10649
0500000US39113,"Montgomery County, Ohio",531239,256395,274844,32512,32821,32643,33184,35702,71119,60567,68327,38525,33954,51590,28366,11929,39.3,413206,390359,110946,91885,413206,195565,217641,91885,38884,53001
0500000US39119,"Muskingum County, Ohio",86068,41853,44215,4779,5520,5810,5796,5567,10394,9944,11492,7213,4608,8475,5149,1321,40.1,66090,63329,17826,14945,66090,31673,34417,14945,6545,8400
0500000US39133,"Portage County, Ohio",161921,78973,82948,7524,8528,8846,14026,19154,17911,17253,21392,13332,9270,14761,7606,2318,37.4,131346,118329,30228,24685,131346,63708,67638,24685,11494,13191
0500000US39139,"Richland County, Ohio",121107,61776,59331,6428,6456,7945,7381,7701,15604,13878,16137,8863,8244,12061,6866,3543,41.3,94989,92076,27188,22470,94989,48286,46703,22470,9517,12953
0500000US39141,"Ross County, Ohio",77000,40376,36624,4303,4174,4732,4566,4683,9827,10270,11159,6279,4807,7085,4016,1099,40.9,60565,58483,15378,12200,60565,32085,28480,12200,5535,6665
0500000US39145,"Scioto County, Ohio",76088,36953,39135,4220,3745,5446,5279,4636,9966,9251,9885,5783,4893,7303,4532,1149,39.7,59336,56060,15043,12984,59336,28573,30763,12984,5609,7375
0500000US39151,"Stark County, Ohio",373612,181115,192497,21162,22981,21885,24214,23668,43602,42003,50066,27942,26753,39071,19213,11052,41.6,292647,278818,84234,69336,292647,140039,152608,69336,30264,39072
0500000US39153,"Summit County, Ohio",540300,262227,278073,30514,28281,35070,33622,34025,70651,62326,75461,38435,39493,52700,25280,14442,41.1,425608,404543,116707,92422,425608,203950,221658,92422,39995,52427
0500000US39155,"Trumbull County, Ohio",201825,97484,104341,10577,13696,9763,11670,12759,23115,21291,26817,14666,16303,23746,10660,6762,44.2,159974,154989,51406,41168,159974,77045,82929,41168,18237,22931
0500000US39157,"Tuscarawas County, Ohio",92420,45251,47169,5635,5288,5857,6431,5579,10412,11081,11771,7250,6044,9390,5050,2632,39.3,71403,68174,20068,17072,71403,34776,36627,17072,7431,9641
0500000US39165,"Warren County, Ohio",227063,114367,112696,13319,15518,17065,16361,12546,25834,31098,34562,15885,13827,18583,8825,3640,39,169931,162225,38713,31048,169931,84248,85683,31048,13864,17184
0500000US39169,"Wayne County, Ohio",116470,58249,58221,7656,7246,8385,8318,8172,13464,13351,14465,8587,7240,10954,6421,2211,38.7,88124,83086,24167,19586,88124,43234,44890,19586,8529,11057
0500000US39173,"Wood County, Ohio",130219,65280,64939,6350,7284,8281,11519,15979,15914,13664,15448,9349,7162,11238,5189,2842,34.8,103644,92532,23656,19269,103644,51096,52548,19269,8668,10601
0500000US40017,"Canadian County, Oklahoma",136532,67095,69437,9197,11239,9799,8815,7800,20011,18475,18579,7415,7859,10931,5088,1324,35.8,100606,96082,21385,17343,100606,48800,51806,17343,7857,9486
0500000US40027,"Cleveland County, Oklahoma",278655,139897,138758,15872,18422,16838,20818,30874,40536,34832,33665,16010,15604,21410,9565,4209,34,217137,198628,44103,35184,217137,107573,109564,35184,15370,19814
0500000US40031,"Comanche County, Oklahoma",122136,63777,58359,8637,8169,8268,9891,11423,17626,14954,15242,7364,6386,8496,4027,1653,33.3,92513,84731,18072,14176,92513,48194,44319,14176,6521,7655
0500000US40037,"Creek County, Oklahoma",71312,35301,36011,4389,5225,4374,4773,4466,7803,8715,9326,5270,4678,7084,4270,939,40,54184,51953,15316,12293,54184,26477,27707,12293,5534,6759
0500000US40101,"Muskogee County, Oklahoma",69477,33850,35627,4921,4226,5064,4916,4542,8774,8129,8202,4797,4510,6649,3106,1641,37.9,52362,49436,14504,11396,52362,25184,27178,11396,4913,6483
0500000US40109,"Oklahoma County, Oklahoma",782970,382993,399977,60788,54885,56026,48088,53331,124707,99258,91743,48875,44200,59192,30138,11739,34.5,581116,552430,127142,101069,581116,280036,301080,101069,43545,57524
0500000US40119,"Payne County, Oklahoma",81131,41436,39695,4585,4427,4553,6936,16555,11945,7916,6806,3688,3802,5602,3140,1176,27.3,65447,55609,12106,9918,65447,33008,32439,9918,4234,5684
0500000US40125,"Pottawatomie County, Oklahoma",72290,35089,37201,4402,5089,4818,5197,5075,9048,8826,9236,4980,4047,6932,3710,930,37.7,54804,51617,13900,11572,54804,25748,29056,11572,5156,6416
0500000US40131,"Rogers County, Oklahoma",91766,45366,46400,5424,6137,6129,6412,5692,10933,10945,12891,6348,5692,9200,4314,1649,39.4,69768,66201,18777,15163,69768,34269,35499,15163,7088,8075
0500000US40143,"Tulsa County, Oklahoma",642940,313474,329466,46850,44964,45715,41621,42455,95331,81958,79259,41218,36664,50331,26665,9909,35.5,478994,454366,108199,86905,478994,229647,249347,86905,37062,49843
0500000US40145,"Wagoner County, Oklahoma",77679,38042,39637,4889,4946,6171,5304,3929,9615,10339,10193,5429,4998,7481,3240,1145,39.1,58332,55763,14228,11866,58332,28357,29975,11866,5530,6336
0500000US41003,"Benton County, Oregon",89385,44722,44663,3895,3341,5077,8876,14365,12230,8462,8927,5540,5054,8067,4453,1098,32.5,74401,64159,16460,13618,74401,36999,37402,13618,6523,7095
0500000US41005,"Clackamas County, Oregon",408062,200839,207223,22766,22204,27720,25018,22389,50163,52716,56311,29284,29872,42480,19025,8114,41.3,319048,304909,86996,69619,319048,155041,164007,69619,31409,38210
0500000US41017,"Deschutes County, Oregon",181307,89988,91319,9438,11221,9832,10542,8747,23012,23198,23773,14467,11694,22873,8532,3978,41.8,143858,138823,42316,35383,143858,70727,73131,35383,16656,18727
0500000US41019,"Douglas County, Oregon",108457,54065,54392,5788,4861,6550,5855,5815,11587,10660,13542,7405,9972,15235,7715,3472,47.2,87138,83742,31841,26422,87138,42601,44537,26422,12446,13976
0500000US41029,"Jackson County, Oregon",216527,105721,110806,11810,12766,13079,12773,11760,26474,25765,25232,15262,16203,26584,12430,6389,43.1,171621,163868,55551,45403,171621,82514,89107,45403,20879,24524
0500000US41033,"Josephine County, Oregon",85904,41022,44882,3811,4030,5378,4478,4449,8281,9918,10139,7611,5644,12790,7386,1989,47.1,69713,66284,26404,22165,69713,33368,36345,22165,10356,11809
0500000US41035,"Klamath County, Oregon",66443,33623,32820,3958,3510,4099,4680,4330,8000,6614,8118,4581,5159,8050,3239,2105,42.1,51840,49507,16499,13394,51840,25616,26224,13394,6560,6834
0500000US41039,"Lane County, Oregon",369519,181794,187725,18753,17865,20514,24909,34371,48416,43208,42569,24687,26186,40880,17779,9382,39.4,300022,280447,84134,68041,300022,146274,153748,68041,30942,37099
0500000US41043,"Linn County, Oregon",122849,61175,61674,7661,9525,6113,7392,6840,16283,14937,14421,8325,8834,13512,5955,3051,39.4,94813,90656,28032,22518,94813,46153,48660,22518,10213,12305
0500000US41047,"Marion County, Oregon",336316,165756,170560,22598,22809,24526,22930,23007,45859,42900,39832,20918,19681,30275,15091,5890,36.4,252479,237652,63788,51256,252479,123899,128580,51256,22735,28521
0500000US41051,"Multnomah County, Oregon",799766,396875,402891,46258,44165,39620,40343,50233,149211,128310,105665,45033,49939,63210,25301,12478,36.8,645414,620520,132534,100989,645414,317659,327755,100989,44360,56629
0500000US41053,"Polk County, Oregon",81823,38468,43355,4790,4604,5199,7662,7376,9220,8556,9401,4817,5735,8355,3377,2731,37.7,63376,57926,17706,14463,63376,30474,32902,14463,6960,7503
0500000US41059,"Umatilla County, Oregon",76456,39719,36737,4996,5084,6176,5625,5236,10521,8750,9575,4196,4970,6725,3198,1404,35.4,56685,52798,13452,11327,56685,29515,27170,11327,5285,6042
0500000US41067,"Washington County, Oregon",582779,286494,296285,37285,39834,37920,35727,34660,89684,87768,77996,35974,32268,44867,16737,12059,36.6,445115,427177,93045,73663,445115,216661,228454,73663,31672,41991
0500000US41071,"Yamhill County, Oregon",105035,53168,51867,5888,7938,5783,7590,8017,12453,13047,13220,6349,7593,9966,4446,2745,38.2,81052,76290,22081,17157,81052,40219,40833,17157,7780,9377
0500000US42001,"Adams County, Pennsylvania",102180,50359,51821,4836,5888,6010,7157,6640,10712,10525,15297,8131,6813,11590,5240,3341,44.2,81386,76929,24282,20171,81386,39885,41501,20171,9147,11024
0500000US42003,"Allegheny County, Pennsylvania",1225365,592374,632991,64979,60514,65859,73230,77134,187568,139558,156360,94016,85309,119477,64564,36797,40.6,993354,946451,270649,220838,993354,473898,519456,220838,92470,128368
0500000US42005,"Armstrong County, Pennsylvania",66486,33041,33445,3221,4201,2981,3479,3310,7238,7361,9750,5074,5703,7951,4102,2115,46.5,53782,51825,17207,14168,53782,26503,27279,14168,6369,7799
0500000US42007,"Beaver County, Pennsylvania",167429,81612,85817,8765,8911,9433,8811,8701,20568,18632,22788,14864,11650,18467,10139,5700,44.9,134851,130267,41708,34306,134851,64973,69878,34306,14712,19594
0500000US42011,"Berks County, Pennsylvania",414812,204372,210440,24568,25617,26263,29798,28044,51096,47307,57949,31599,24301,38187,21356,8727,40.1,321041,303035,81456,68270,321041,156052,164989,68270,30124,38146
0500000US42013,"Blair County, Pennsylvania",124650,61100,63550,6786,5775,8567,7564,6798,14774,14304,16314,9450,9088,13766,7423,4041,43.8,98962,94653,30393,25230,98962,47505,51457,25230,10828,14402
0500000US42017,"Bucks County, Pennsylvania",626399,307346,319053,30747,37464,37162,39415,36200,69141,72659,95849,51197,46261,62630,31449,16225,43.7,495308,474155,138137,110304,495308,240350,254958,110304,48958,61346
0500000US42019,"Butler County, Pennsylvania",186847,92823,94024,9108,11450,9988,12769,10669,20915,21977,27826,16162,12365,18842,9454,5322,43.3,148939,141460,41440,33618,148939,72972,75967,33618,15090,18528
0500000US42021,"Cambria County, Pennsylvania",134732,66143,68589,6651,8392,6341,8688,8616,13864,14638,17496,10202,10840,15877,8821,4306,45.1,108823,102584,35743,29004,108823,52890,55933,29004,12457,16547
0500000US42025,"Carbon County, Pennsylvania",63594,32121,31473,3018,3166,3791,3282,3180,6929,7351,9815,4632,5618,7546,3364,1902,46.2,51288,49184,16206,12812,51288,25662,25626,12812,5831,6981
0500000US42027,"Centre County, Pennsylvania",161464,85208,76256,6150,6694,7302,20711,21270,24229,16842,18385,8196,10510,12014,6464,2697,31.7,136981,113857,27717,21175,136981,73222,63759,21175,9692,11483
0500000US42029,"Chester County, Pennsylvania",516312,254127,262185,29156,33120,35405,36310,32902,58354,62930,76428,38385,33945,46263,21602,11512,40.3,396743,376416,97839,79377,396743,193093,203650,79377,35407,43970
0500000US42033,"Clearfield County, Pennsylvania",80596,42229,38367,3530,4246,4294,4288,4835,9387,9909,12129,6331,5772,8628,5327,1920,44.8,65809,63607,19740,15875,65809,34632,31177,15875,7055,8820
0500000US42037,"Columbia County, Pennsylvania",66420,31694,34726,2852,3482,3208,5551,7586,6692,6979,8545,5260,4171,6845,3227,2022,40.6,54670,49343,14257,12094,54670,25713,28957,12094,5304,6790
0500000US42039,"Crawford County, Pennsylvania",86257,42103,44154,4760,5333,4690,6063,5440,9736,9170,11556,6497,6444,9894,4905,1769,42.7,68090,64284,20489,16568,68090,32918,35172,16568,7673,8895
0500000US42041,"Cumberland County, Pennsylvania",248506,123073,125433,12868,13722,14277,18101,15394,32573,29971,34217,16593,17097,24503,12977,6213,40.2,197939,186583,53254,43693,197939,96799,101140,43693,18995,24698
0500000US42043,"Dauphin County, Pennsylvania",273707,131911,141796,17348,15443,17733,17008,16493,37473,33290,36244,20750,18771,24651,12184,6319,39.6,212481,203782,54269,43154,212481,100990,111491,43154,18600,24554
0500000US42045,"Delaware County, Pennsylvania",563402,270782,292620,33832,33766,35201,40540,39073,72341,66123,76230,40281,37833,47707,26467,14008,39,438293,411610,111470,88182,438293,207011,231282,88182,37033,51149
0500000US42049,"Erie County, Pennsylvania",276207,136372,139835,15544,17965,15475,20212,18557,35974,30203,37227,19874,19669,25955,12278,7274,39.2,216297,203439,57285,45507,216297,105723,110574,45507,19942,25565
0500000US42051,"Fayette County, Pennsylvania",132733,65462,67271,6951,5808,8260,7085,7336,15319,16056,18462,10220,10945,14908,8103,3280,44.8,106854,103527,33476,26291,106854,52187,54667,26291,11529,14762
0500000US42055,"Franklin County, Pennsylvania",153851,76604,77247,7888,9480,10954,10476,8456,16572,18616,21129,10231,10833,16293,8382,4541,41.8,119059,113898,36035,29216,119059,57940,61119,29216,12795,16421
0500000US42063,"Indiana County, Pennsylvania",86364,43621,42743,4011,3939,5011,7387,9522,9296,8153,10314,7315,5559,8866,5253,1738,39.7,70732,63495,19446,15857,70732,35728,35004,15857,7339,8518
0500000US42069,"Lackawanna County, Pennsylvania",211321,101894,109427,11187,11542,12605,13465,13018,26897,23248,28283,15178,14400,22703,11349,7446,41.7,168610,159559,50463,41498,168610,80412,88198,41498,17879,23619
0500000US42071,"Lancaster County, Pennsylvania",538500,264057,274443,35667,37203,33568,36917,34383,69728,60922,68170,35614,34641,49110,27974,14603,38.2,410044,388944,112202,91687,410044,197944,212100,91687,40496,51191
0500000US42073,"Lawrence County, Pennsylvania",87294,42742,44552,4622,4782,4779,5239,5302,9302,9664,11659,6780,7128,9577,5537,2923,45,69893,66588,22032,18037,69893,33692,36201,18037,7745,10292
0500000US42075,"Lebanon County, Pennsylvania",138863,67675,71188,8651,8515,9752,8733,8942,15866,15255,18587,9619,9177,14065,8050,3651,41.2,106721,99670,31396,25766,106721,51172,55549,25766,11480,14286
0500000US42077,"Lehigh County, Pennsylvania",363147,177485,185662,21556,23366,22895,24140,23227,47317,45322,48306,24974,22454,32674,17718,9198,39,280634,266681,72534,59590,280634,134822,145812,59590,25856,33734
0500000US42079,"Luzerne County, Pennsylvania",316383,155463,160920,16186,16385,18406,18862,20496,38737,35898,44835,25012,20382,33455,17062,10667,43.1,254555,241324,73463,61184,254555,124474,130081,61184,25937,35247
0500000US42081,"Lycoming County, Pennsylvania",115248,56210,59038,6714,6124,7258,7185,7379,15356,12332,15015,9000,7569,11945,5761,3610,40.6,91510,85952,26079,21316,91510,43992,47518,21316,9294,12022
0500000US42085,"Mercer County, Pennsylvania",112913,55637,57276,5404,5925,6098,7930,7733,11508,11702,16250,8123,8911,12339,7079,3911,45.1,90948,85393,28991,23329,90948,44783,46165,23329,10097,13232
0500000US42089,"Monroe County, Pennsylvania",166098,82312,83786,7151,9441,9957,12839,13562,17522,17913,25188,14665,11111,17376,6549,2824,41.9,132528,121889,33451,26749,132528,64917,67611,26749,12086,14663
0500000US42091,"Montgomery County, Pennsylvania",821725,399488,422237,45506,49490,51283,50283,48330,101652,101394,117131,59227,56133,76558,42061,22677,41.4,643371,616424,174000,141296,643371,308365,335006,141296,60602,80694
0500000US42095,"Northampton County, Pennsylvania",302294,149254,153040,14634,16489,18510,21308,20342,35822,34815,42433,21388,22125,30074,15194,9160,41.6,241048,226158,67130,54428,241048,117155,123893,54428,23828,30600
0500000US42097,"Northumberland County, Pennsylvania",92541,47301,45240,5056,5020,5091,4775,4841,10721,11166,13254,7407,6584,10078,5487,3061,44.7,74174,71746,22324,18626,74174,37607,36567,18626,8194,10432
0500000US42101,"Philadelphia County, Pennsylvania",1567872,743380,824492,107509,94280,90674,98338,119266,295799,191490,187268,96270,85373,115050,58834,27721,34.1,1221937,1154488,249531,201605,1221937,566137,655800,201605,80138,121467
0500000US42107,"Schuylkill County, Pennsylvania",143573,73503,70070,6990,7484,8401,7495,7563,17355,17905,20605,11046,10195,15833,8580,4121,44.4,115664,111939,33878,28534,115664,59284,56380,28534,12628,15906
0500000US42111,"Somerset County, Pennsylvania",75061,38762,36299,3684,3683,3724,3815,4204,8781,8837,10629,6153,5656,8634,5294,1967,45.7,61452,59226,19538,15895,61452,31914,29538,15895,7267,8628
0500000US42125,"Washington County, Pennsylvania",207981,101664,106317,10602,10634,12226,13204,11907,23432,23238,29396,15921,17108,22780,12178,5355,44.6,167032,159002,50569,40313,167032,80635,86397,40313,17603,22710
0500000US42129,"Westmoreland County, Pennsylvania",355458,173607,181851,16249,18007,19083,20147,20444,36524,39274,50527,29409,28453,42792,22303,12246,46.7,289510,278304,93208,77341,289510,139879,149631,77341,33558,43783
0500000US42133,"York County, Pennsylvania",443744,218703,225041,25153,26448,29531,28226,26156,54087,52902,64721,34333,27967,42681,21806,9733,41.2,345451,328304,89770,74220,345451,168618,176833,74220,32867,41353
0500000US44003,"Kent County, Rhode Island",164614,79351,85263,7394,8723,9352,8778,8567,22048,20032,24631,13535,11972,16717,8186,4679,43.5,133463,129211,35763,29582,133463,63116,70347,29582,12514,17068
0500000US44005,"Newport County, Rhode Island",82784,40195,42589,3536,4161,4522,4513,6011,9612,8569,11761,6593,6280,9921,5219,2086,45.6,67753,65395,20742,17226,67753,32183,35570,17226,7555,9671
0500000US44007,"Providence County, Rhode Island",633673,307712,325961,36395,32154,39883,44487,49170,94719,77500,84726,43610,37856,50791,25868,16514,37.5,502007,468855,115485,93173,502007,240520,261487,93173,39471,53702
0500000US44009,"Washington County, Rhode Island",126288,60512,65776,4788,3927,7876,11780,11517,11045,11931,18566,10337,9855,14489,6819,3358,45.1,104808,94709,31131,24666,104808,49877,54931,24666,10980,13686
0500000US45003,"Aiken County, South Carolina",167458,81683,85775,9439,10021,10243,10599,9652,21235,19877,21845,11653,12365,18352,8974,3203,40.8,131369,125681,37972,30529,131369,62107,69262,30529,13820,16709
0500000US45007,"Anderson County, South Carolina",196569,94805,101764,11865,11421,13993,12956,11790,23518,23563,26687,13599,12673,20313,10578,3613,40.4,151527,144510,42401,34504,151527,71518,80009,34504,15012,19492
0500000US45013,"Beaufort County, South Carolina",183149,89378,93771,10024,11641,9246,10804,10691,20433,18984,19844,11794,12246,29950,11804,5688,44.9,147652,138605,53680,47442,147652,71671,75981,47442,22212,25230
0500000US45015,"Berkeley County, South Carolina",210898,104553,106345,13633,13609,15260,14471,14956,30167,27735,27920,13994,11685,18008,6835,2625,36.4,159903,150665,34412,27468,159903,78763,81140,27468,12286,15182
0500000US45019,"Charleston County, South Carolina",396484,190528,205956,24116,21968,21245,21822,26051,68697,51674,48286,23877,28189,37629,15633,7297,37.1,317126,302409,77331,60559,317126,151171,165955,60559,26163,34396
0500000US45031,"Darlington County, South Carolina",67234,31105,36129,4117,3605,4693,5540,3261,7664,8053,8768,5078,4507,7713,2941,1294,41.2,51938,48631,15096,11948,51938,24033,27905,11948,5143,6805
0500000US45035,"Dorchester County, South Carolina",153773,75358,78415,9333,10184,12338,10233,9430,20573,21977,21076,8941,9785,13475,4504,1924,36.3,115002,109676,25390,19903,115002,54900,60102,19903,8769,11134
0500000US45041,"Florence County, South Carolina",138742,64489,74253,8578,9985,9176,9055,8287,17773,17786,17737,8732,9283,13746,6783,1821,39,105545,100154,27434,22350,105545,47587,57958,22350,9306,13044
0500000US45045,"Greenville County, South Carolina",498766,242098,256668,31895,32787,32107,31750,31365,69012,64587,67580,33155,29380,45464,22084,7600,38.1,382754,364732,91285,75148,382754,182904,199850,75148,32595,42553
0500000US45047,"Greenwood County, South Carolina",70133,32128,38005,4292,5089,4088,6158,4958,7870,8047,8520,4173,4682,6713,4178,1365,37.8,52967,49491,15245,12256,52967,23809,29158,12256,5211,7045
0500000US45051,"Horry County, South Carolina",322342,155255,167087,15641,16673,17215,17997,17453,38192,36779,41304,24955,24481,47203,18050,6399,45.3,262397,250553,85977,71652,262397,124976,137421,71652,33433,38219
0500000US45057,"Lancaster County, South Carolina",89594,44583,45011,5446,5500,5381,4312,5256,9910,12496,11572,5224,6695,10968,5142,1692,42.6,70282,67715,21520,17802,70282,34048,36234,17802,7979,9823
0500000US45059,"Laurens County, South Carolina",66777,32541,34236,3667,4813,3744,3911,5097,8210,7294,9072,5698,3607,6932,2914,1818,39.2,52067,49401,13899,11664,52067,24545,27522,11664,5112,6552
0500000US45063,"Lexington County, South Carolina",286196,139230,146966,16897,18844,19765,17744,15758,38263,37882,39891,19839,18221,26852,11272,4968,38.9,219144,210460,53462,43092,219144,105209,113935,43092,19296,23796
0500000US45073,"Oconee County, South Carolina",76355,36795,39560,4134,3390,5549,4244,4386,9345,7397,9216,6183,5302,10539,4760,1910,44.7,60878,58221,20438,17209,60878,29597,31281,17209,8163,9046
0500000US45075,"Orangeburg County, South Carolina",87903,41321,46582,5201,6248,5543,6360,6068,10307,9121,11163,6276,5816,9531,4500,1769,39.4,67408,63012,18964,15800,67408,30872,36536,15800,6721,9079
0500000US45077,"Pickens County, South Carolina",122863,60735,62128,6465,6527,6923,11153,14031,14620,13566,15215,8175,6552,11615,5894,2127,36.3,98588,87565,23743,19636,98588,48276,50312,19636,8649,10987
0500000US45079,"Richland County, South Carolina",409549,198431,211118,23896,26670,23001,37599,43031,60653,50514,48615,22931,23084,30970,12630,5955,33.4,320613,290598,63917,49555,320613,153503,167110,49555,20932,28623
0500000US45083,"Spartanburg County, South Carolina",301463,146664,154799,18708,20247,19104,20731,20282,38799,37149,40592,20476,17914,28649,13983,4829,38.1,231267,217352,59325,47461,231267,110589,120678,47461,20792,26669
0500000US45085,"Sumter County, South Carolina",107396,52411,54985,7606,7815,6446,7612,8130,14528,11673,13635,6349,6898,9681,5081,1942,36.1,81323,76394,20833,16704,81323,38095,43228,16704,7027,9677
0500000US45091,"York County, South Carolina",258526,124462,134064,16028,16875,19659,17006,15759,31931,35431,38059,17147,15054,22441,10281,2855,38.7,195328,184684,43848,35577,195328,92491,102837,35577,15795,19782
0500000US46099,"Minnehaha County, South Dakota",187318,94159,93159,14449,13841,12119,11895,12454,29232,24220,21826,12543,10756,14151,6561,3271,34.9,139976,131563,29716,23983,139976,69644,70332,23983,10373,13610
0500000US46103,"Pennington County, South Dakota",109372,54783,54589,7504,7736,6289,6211,7294,15099,11950,13210,8535,7136,10788,5610,2010,38.3,83823,79783,22719,18408,83823,41204,42619,18408,8383,10025
0500000US47001,"Anderson County, Tennessee",75936,37839,38097,4502,4208,4238,3822,4875,8725,8997,10581,6520,4872,8374,4583,1639,43.4,60243,58348,17709,14596,60243,29425,30818,14596,6505,8091
0500000US47009,"Blount County, Tennessee",128670,62288,66382,6782,6408,8323,7865,7169,15453,14254,18894,8268,10223,15078,7386,2567,43.7,101940,97757,30545,25031,101940,48883,53057,25031,11264,13767
0500000US47011,"Bradley County, Tennessee",104490,50653,53837,5017,7113,6632,6914,7147,13323,12973,15172,6772,6458,10008,5344,1617,39.2,82038,76842,19794,16969,82038,39472,42566,16969,7304,9665
0500000US47037,"Davidson County, Tennessee",684410,329473,354937,47096,40722,37699,38663,51298,134458,93672,83218,42746,36175,47409,22844,8410,34.2,538168,510749,97515,78663,538168,255925,282243,78663,33121,45542
0500000US47059,"Greene County, Tennessee",68615,33969,34646,3075,3181,4023,4919,4005,6985,8290,9898,5725,3963,8568,4490,1493,44.9,55782,52822,17158,14551,55782,27272,28510,14551,6358,8193
0500000US47065,"Hamilton County, Tennessee",357738,173590,184148,19752,19670,22363,22353,23717,49364,45244,47266,23654,25350,33703,18432,6870,39,282494,267894,74924,59005,282494,133872,148622,59005,25510,33495
0500000US47093,"Knox County, Tennessee",456132,222119,234013,26815,26460,27512,29243,41233,61463,56792,59989,28846,28017,40487,20829,8446,37.3,359308,336865,86925,69762,359308,171351,187957,69762,29593,40169
0500000US47113,"Madison County, Tennessee",97663,46549,51114,6239,5334,6693,7235,7516,10755,12244,13014,7460,5566,9207,4850,1550,38,75476,70477,18746,15607,75476,34582,40894,15607,6697,8910
0500000US47119,"Maury County, Tennessee",89981,44105,45876,5781,6691,5066,5571,4919,11696,11358,12374,5840,6469,8956,3906,1354,39.9,68906,66031,17634,14216,68906,32592,36314,14216,6121,8095
0500000US47125,"Montgomery County, Tennessee",195734,96375,99359,16811,15446,12976,12640,16982,37596,24491,22778,9907,8517,10969,4701,1920,30.8,142872,133289,22413,17590,142872,70688,72184,17590,7652,9938
0500000US47141,"Putnam County, Tennessee",75931,37714,38217,4271,4283,4685,6909,6496,10134,8354,8653,4224,5131,7913,3360,1518,36.7,59696,53794,15655,12791,59696,29612,30084,12791,5651,7140
0500000US47147,"Robertson County, Tennessee",69165,33717,35448,4488,5054,4668,3956,3731,9480,8786,9874,5148,4263,6026,3018,673,37.9,52193,50229,12720,9717,52193,25304,26889,9717,4498,5219
0500000US47149,"Rutherford County, Tennessee",308251,151436,156815,20262,22127,21733,22765,29768,43743,43924,40351,17592,14635,20113,8599,2639,33.1,231483,216406,40347,31351,231483,111964,119519,31351,13604,17747
0500000US47155,"Sevier County, Tennessee",96673,48504,48169,5575,6105,5479,6148,5191,12318,11045,13205,6919,6849,11176,5268,1395,41.3,75533,72343,22286,17839,75533,36492,39041,17839,8221,9618
0500000US47157,"Shelby County, Tennessee",934603,445343,489260,67068,59928,69242,63476,66487,135342,117341,121387,61251,55788,70733,32098,14462,35.5,699010,661630,149572,117293,699010,325463,373547,117293,48521,68772
0500000US47163,"Sullivan County, Tennessee",156667,75796,80871,8011,9287,7682,9372,8491,17234,18192,22584,11854,11064,18582,10138,4176,45,125945,120030,39180,32896,125945,60192,65753,32896,14469,18427
0500000US47165,"Sumner County, Tennessee",180063,87834,92229,11303,11649,12660,11730,9974,21327,24293,26425,10756,12398,16617,7577,3354,40.1,136847,131174,34373,27548,136847,65526,71321,27548,12258,15290
0500000US47179,"Washington County, Tennessee",127440,62924,64516,5544,6686,8240,8148,11523,14869,15557,17876,8207,8077,13682,7194,1837,39.9,102603,96409,27828,22713,102603,49466,53137,22713,10468,12245
0500000US47187,"Williamson County, Tennessee",219107,107205,111902,12845,16763,19676,15991,11548,20090,32869,34255,15321,13318,16624,7912,1895,39,158558,150850,33852,26431,158558,76115,82443,26431,11955,14476
0500000US47189,"Wilson County, Tennessee",132781,65113,67668,7947,8787,9667,8676,6650,15200,17901,19857,9217,8513,13348,5189,1829,41.1,101180,96133,25064,20366,101180,49148,52032,20366,9501,10865
0500000US48005,"Angelina County, Texas",87791,42273,45518,5524,6385,7100,6166,5914,9754,11017,11313,6055,4753,7724,3732,2354,37.6,65106,60626,16515,13810,65106,31087,34019,13810,5600,8210
0500000US48021,"Bastrop County, Texas",82733,42343,40390,4962,4743,6609,5880,6033,8189,11820,11154,4665,6454,8331,2060,1833,38.7,63030,57841,16281,12224,63030,32025,31005,12224,5438,6786
0500000US48027,"Bell County, Texas",340411,169564,170847,29272,26844,24735,23560,29927,57857,43627,37137,17968,13940,21295,10841,3408,31,245385,230164,43860,35544,245385,121362,124023,35544,15867,19677
0500000US48029,"Bexar County, Texas",1928680,951190,977490,140137,135879,141764,139603,145812,304334,256376,235217,108728,94194,133548,67977,25111,33.5,1427988,1340240,282284,226636,1427988,696325,731663,226636,97781,128855
0500000US48037,"Bowie County, Texas",93860,47367,46493,5298,7345,6379,6220,4934,14077,11657,11112,5889,5635,8926,4746,1642,37,71338,67301,18347,15314,71338,36214,35124,15314,6917,8397
0500000US48039,"Brazoria County, Texas",354195,178453,175742,25165,27021,26925,25157,19689,48479,52048,47853,21738,20508,24717,10066,4829,36,259784,245709,51527,39612,259784,130492,129292,39612,18108,21504
0500000US48041,"Brazos County, Texas",220417,112020,108397,13132,13040,11934,24839,41417,35446,23763,19911,8977,8152,11938,5914,1954,26.1,175222,144487,25224,19806,175222,88589,86633,19806,9253,10553
0500000US48061,"Cameron County, Texas",422135,204626,217509,35878,34864,37533,35771,32146,50179,52529,46948,22962,17862,31158,18611,5694,31.5,291174,269589,66139,55463,291174,138095,153079,55463,24565,30898
0500000US48085,"Collin County, Texas",939585,461416,478169,59881,70278,75119,67842,53107,118559,149597,144167,56954,45527,63054,27833,7667,36.5,689140,656887,123531,98554,689140,334082,355058,98554,43097,55457
0500000US48091,"Comal County, Texas",134788,66708,68080,7613,8009,9169,10381,7108,13034,16589,18818,10296,9551,14468,7798,1954,42.6,104556,98230,29262,24220,104556,51259,53297,24220,11240,12980
0500000US48099,"Coryell County, Texas",74686,37817,36869,5567,5172,4507,4163,7705,14508,10775,8405,4005,2589,4212,1802,1276,31.7,57040,53505,8618,7290,57040,28712,28328,7290,3711,3579
0500000US48113,"Dallas County, Texas",2574984,1267526,1307458,196093,200043,182154,174048,184076,415787,356378,328727,150086,127201,157632,72583,30176,33.3,1887641,1788168,328866,260391,1887641,917045,970596,260391,111223,149168
0500000US48121,"Denton County, Texas",806180,396322,409858,52575,59296,58398,58175,53497,119677,124349,117851,48812,37594,49682,19506,6768,35.1,600568,566016,100097,75956,600568,291192,309376,75956,33763,42193
0500000US48135,"Ector County, Texas",157462,80102,77360,14495,14429,11649,10815,12750,25669,18997,17229,8534,7788,8556,4446,2105,30.4,109972,104180,20435,15107,109972,55161,54811,15107,6485,8622
0500000US48139,"Ellis County, Texas",168499,83163,85336,11449,12162,13373,13027,10855,21414,22025,22649,10668,9688,13914,6456,819,36.1,123407,115922,26274,21189,123407,59906,63501,21189,9119,12070
0500000US48141,"El Paso County, Texas",837918,411497,426421,65525,62405,65027,64400,69981,125016,104160,95916,45286,40350,55945,30359,13548,32.1,605632,568314,123905,99852,605632,294136,311496,99852,42277,57575
0500000US48157,"Fort Bend County, Texas",741237,364149,377088,52109,57481,59520,53940,43252,91859,112298,104134,49799,39387,50926,19609,6923,36,536318,508337,100911,77458,536318,259374,276944,77458,35219,42239
0500000US48167,"Galveston County, Texas",329431,162548,166883,21908,22821,22357,23251,19323,43928,42971,44172,23833,20865,27388,12275,4339,37.1,248615,234383,56627,44002,248615,121125,127490,44002,19705,24297
0500000US48181,"Grayson County, Texas",128235,62706,65529,8316,9085,7879,8931,7398,14998,15709,16394,9986,6975,13321,6524,2719,40,97602,92531,26405,22564,97602,46656,50946,22564,9540,13024
0500000US48183,"Gregg County, Texas",123745,61139,62606,9509,9906,8271,8324,7909,16751,15256,14265,8591,6844,10013,5588,2518,35.5,91884,86156,21496,18119,91884,44943,46941,18119,7740,10379
0500000US48187,"Guadalupe County, Texas",155265,76684,78581,9977,11073,11482,11694,10065,19560,20956,21768,8965,8598,13126,5859,2142,37,115283,108263,26269,21127,115283,55987,59296,21127,9628,11499
0500000US48201,"Harris County, Texas",4589928,2281026,2308902,355835,348411,337748,312271,322819,742905,652816,576304,271036,222041,279668,120039,48035,33.3,3350806,3177966,571037,447742,3350806,1650782,1700024,447742,197509,250233
0500000US48203,"Harrison County, Texas",66534,31892,34642,3934,4540,5515,5853,3318,7933,7946,8432,5030,3630,6316,2681,1406,37.2,49549,45865,12544,10403,49549,23601,25948,10403,4570,5833
0500000US48209,"Hays County, Texas",204470,100110,104360,12808,14451,12771,15839,27550,29332,25474,23601,10964,10187,14270,5616,1607,31.2,156949,140735,26663,21493,156949,76617,80332,21493,9981,11512
0500000US48213,"Henderson County, Texas",79901,38440,41461,4429,4382,5324,4911,4906,8836,8110,10022,5566,6343,9821,5474,1777,43.7,62520,59284,21270,17072,62520,29566,32954,17072,7882,9190
0500000US48215,"Hidalgo County, Texas",849843,415546,434297,81689,71698,83526,72809,66755,110931,109591,90377,32801,35906,53096,29708,10956,29.2,566951,524258,116345,93760,566951,271595,295356,93760,41780,51980
0500000US48231,"Hunt County, Texas",92073,45503,46570,6165,5580,6498,7598,6073,10743,10677,12325,7325,5130,8370,4300,1289,38.1,69780,65418,17108,13959,69780,33902,35878,13959,6178,7781
0500000US48245,"Jefferson County, Texas",254679,130673,124006,17657,16621,16725,15721,19030,37871,32996,31126,16234,15796,19547,10753,4602,35.9,193951,183587,43653,34902,193951,99943,94008,34902,15273,19629
0500000US48251,"Johnson County, Texas",163274,81331,81943,10527,11623,13143,11424,9871,20805,20721,21754,12009,8481,13938,6482,2496,36.9,120772,115175,27532,22916,120772,59141,61631,22916,10309,12607
0500000US48257,"Kaufman County, Texas",118350,58708,59642,8360,8339,9996,8352,7085,15925,16847,15229,8103,6025,8776,4329,984,36,85946,82148,17502,14089,85946,41947,43999,14089,6517,7572
0500000US48291,"Liberty County, Texas",81704,41468,40236,5391,6647,5263,5335,5107,11279,10402,11547,5883,4210,6965,2634,1041,36.7,60869,57200,12787,10640,60869,29668,31201,10640,5003,5637
0500000US48303,"Lubbock County, Texas",303137,149132,154005,21126,20892,19797,24692,38009,45002,33978,31415,17266,14441,20302,11386,4831,30.6,230277,207175,45051,36519,230277,112877,117400,36519,15820,20699
0500000US48309,"McLennan County, Texas",247934,120728,127206,17353,17096,16407,21757,25625,31375,27804,28227,14360,13438,19761,10970,3761,33.3,186579,169361,42040,34492,186579,89356,97223,34492,14886,19606
0500000US48329,"Midland County, Texas",162565,81341,81224,14593,11803,13538,9650,11793,28604,20784,17416,9839,7869,8394,5921,2361,32,115975,110698,20774,16676,115975,57811,58164,16676,7132,9544
0500000US48339,"Montgomery County, Texas",556203,276246,279957,38396,43527,40592,40196,31943,69629,75780,77265,38170,30162,45623,17697,7223,37.2,407973,387409,88587,70543,407973,199707,208266,70543,32405,38138
0500000US48347,"Nacogdoches County, Texas",65806,31281,34525,4152,4954,4178,6728,8834,7388,6792,6759,4857,2352,5240,2243,1329,30.7,50292,44266,10437,8812,50292,23713,26579,8812,3761,5051
0500000US48355,"Nueces County, Texas",361350,178469,182881,25110,24889,24904,25924,26903,52869,43909,43914,23260,19766,29031,15276,5595,35,270763,255045,62246,49902,270763,132003,138760,49902,22141,27761
0500000US48361,"Orange County, Texas",84964,41889,43075,6025,5275,6321,5180,5505,11130,9953,11295,6298,4908,7597,4440,1037,37.4,63686,61180,15901,13074,63686,31093,32593,13074,5819,7255
0500000US48367,"Parker County, Texas",129441,64651,64790,8302,8496,9730,8199,7516,15685,14350,19176,9512,8405,12853,5212,2005,40,97209,93574,24635,20070,97209,48010,49199,20070,9491,10579
0500000US48375,"Potter County, Texas",120832,62406,58426,9298,9544,9022,8606,7963,17984,15996,14803,7814,5025,8355,4869,1553,33.8,87657,82415,17721,14777,87657,45004,42653,14777,6304,8473
0500000US48381,"Randall County, Texas",132501,65222,67279,8474,9160,9084,10336,8764,19021,17393,15429,8659,7774,10876,5107,2424,35.5,100389,93333,23039,18407,100389,48584,51805,18407,8153,10254
0500000US48397,"Rockwall County, Texas",93978,45729,48249,4954,6723,9039,7969,5280,9289,14959,13059,5514,5522,6479,3644,1547,37.5,68270,64157,15353,11670,68270,32772,35498,11670,5143,6527
0500000US48409,"San Patricio County, Texas",67655,34245,33410,5000,4328,5615,4474,5336,8376,8702,7937,4791,3166,5983,3006,941,35.6,49523,46912,11501,9930,49523,24712,24811,9930,4621,5309
0500000US48423,"Smith County, Texas",225290,108293,116997,15819,16291,14157,16271,15311,30196,27073,26927,14803,12596,20125,10639,5082,36.5,169600,160293,42903,35846,169600,80484,89116,35846,15873,19973
0500000US48439,"Tarrant County, Texas",2016872,985977,1030895,145627,150345,154051,142314,135933,300187,274487,269693,120225,106354,133084,62053,22519,34.3,1477573,1400637,279661,217656,1477573,711148,766425,217656,94668,122988
0500000US48441,"Taylor County, Texas",136535,67109,69426,10059,10102,8663,10724,12912,20474,14423,14787,6723,8163,10838,6470,2197,32.8,103024,95027,24808,19505,103024,49796,53228,19505,8347,11158
0500000US48451,"Tom Green County, Texas",118386,58379,60007,8416,6634,8401,9824,9254,18668,12836,12965,6889,6686,10102,5231,2480,33.8,90670,82592,21723,17813,90670,44678,45992,17813,7980,9833
0500000US48453,"Travis County, Texas",1199323,604685,594638,79506,75467,73916,72007,82164,241015,188479,153395,68186,56761,68797,28296,11334,33.7,929486,882556,142485,108427,929486,466817,462669,108427,48449,59978
0500000US48469,"Victoria County, Texas",92467,45014,47453,7057,5728,6848,5998,6472,12431,11491,11016,6210,4728,8560,4128,1800,36.1,69061,65868,17160,14488,69061,33544,35517,14488,6211,8277
0500000US48471,"Walker County, Texas",71484,42074,29410,4466,1933,3386,5392,10642,10827,9017,9547,5447,2740,4887,2137,1063,34.1,60468,54397,9777,8087,60468,36229,24239,8087,3990,4097
0500000US48479,"Webb County, Texas",271193,131568,139625,27152,24344,25922,23622,21878,36551,35076,29598,12685,9804,14464,7065,3032,28.1,178950,163493,30772,24561,178950,85506,93444,24561,10564,13997
0500000US48485,"Wichita County, Texas",131838,68077,63761,8881,8473,7569,11138,11518,20854,14772,13409,8194,8228,10253,5109,3440,34,102605,93275,23829,18802,102605,53092,49513,18802,8014,10788
0500000US48491,"Williamson County, Texas",528718,259891,268827,35577,38017,42017,37214,28292,73224,85696,71824,27971,25863,39542,16321,7160,36.2,389354,370819,77112,63023,389354,188566,200788,63023,27221,35802
0500000US49005,"Cache County, Utah",122753,60795,61958,11144,10239,10827,10882,17603,17065,14681,9700,4512,4993,6232,3095,1780,25.3,85023,76989,14255,11107,85023,41733,43290,11107,5176,5931
0500000US49011,"Davis County, Utah",342281,173129,169152,30117,33587,30695,27100,22602,48122,48341,36877,16737,15975,19170,9209,3749,30.9,230105,217090,40966,32128,230105,114750,115355,32128,15050,17078
0500000US49035,"Salt Lake County, Utah",1121354,562661,558693,87581,91907,83713,77707,79292,184154,162085,126873,59470,54777,68977,32718,12100,32.7,808315,766238,145890,113795,808315,402597,405718,113795,51088,62707
0500000US49049,"Utah County, Utah",592299,299911,292388,57606,58304,55703,55012,75078,84672,73741,49003,21003,18224,25811,13132,5010,24.6,389802,351475,54347,43953,389802,195189,194613,43953,19901,24052
0500000US49053,"Washington County, Utah",160245,79883,80362,11401,13373,10887,13011,10075,19184,17678,14440,7789,9720,17992,10721,3974,35.9,116938,109418,38423,32687,116938,57564,59374,32687,15764,16923
0500000US49057,"Weber County, Utah",247560,124784,122776,19932,20171,19412,17658,18170,37331,33483,26367,15785,11174,16929,7605,3543,32.4,176320,166491,33885,28077,176320,88254,88066,28077,12941,15136
0500000US50007,"Chittenden County, Vermont",161531,79754,81777,8019,7859,8926,12777,17732,21811,18845,21918,11774,9388,13324,6198,2960,37.2,132018,120073,28117,22482,132018,64220,67798,22482,9618,12864
0500000US51003,"Albemarle County, Virginia",106878,50994,55884,5320,7450,5121,9780,7029,14047,12115,12947,8800,5825,9964,5587,2893,38.2,85229,77328,21732,18444,85229,40078,45151,18444,8150,10294
0500000US51013,"Arlington County, Virginia",230050,114984,115066,13907,12685,9020,7520,16140,56669,38998,29675,12983,10341,13727,5107,3278,34.8,189170,185500,28406,22112,189170,93791,95379,22112,9557,12555
0500000US51015,"Augusta County, Virginia",74997,37498,37499,3664,2870,5469,4551,4247,8202,8292,11125,6538,5221,8806,4611,1401,45.2,60232,57850,17740,14818,60232,30185,30047,14818,7014,7804
0500000US51019,"Bedford County, Virginia",77960,38851,39109,3541,4123,5709,3832,4571,7838,8286,11584,5946,6356,9951,4556,1667,45.8,61834,59803,19805,16174,61834,30292,31542,16174,7544,8630
0500000US51041,"Chesterfield County, Virginia",339009,163650,175359,19949,22275,24036,23747,21463,40331,45324,48933,23852,21327,31253,12286,4233,39.2,257516,245649,59434,47772,257516,121370,136146,47772,21014,26758
0500000US51059,"Fairfax County, Virginia",1138652,564379,574273,73697,75985,75347,73038,67762,152599,165011,168561,77169,67976,87428,37077,17002,38.1,867742,829076,179952,141507,867742,425391,442351,141507,64721,76786
0500000US51061,"Fauquier County, Virginia",69069,34383,34686,4219,3549,5480,3893,4333,7426,8154,11098,4485,5488,6681,3254,1009,41.5,52921,51291,14350,10944,52921,26135,26786,10944,5224,5720
0500000US51069,"Frederick County, Virginia",84421,41801,42620,5096,5573,5177,5664,5039,10345,9800,12596,7256,4298,8004,3586,1987,40.9,64934,62328,15515,13577,64934,31594,33340,13577,6170,7407
0500000US51085,"Hanover County, Virginia",104392,51683,52709,4712,6124,7415,7812,6533,10359,11618,16709,8442,7289,10583,4519,2277,44.1,81322,76785,21335,17379,81322,39649,41673,17379,7726,9653
0500000US51087,"Henrico County, Virginia",326501,153668,172833,20186,21588,21283,18746,18877,47225,43645,44909,20926,20796,28082,12346,7892,38.8,251025,241829,60275,48320,251025,115497,135528,48320,19508,28812
0500000US51095,"James City County, Virginia",74404,34824,39580,2418,4170,5959,5755,2479,6985,7841,9743,4600,5596,10731,6103,2024,47.2,59129,55115,22720,18858,59129,27573,31556,18858,8422,10436
0500000US51107,"Loudoun County, Virginia",385945,191567,194378,28017,33566,31337,26427,20137,46386,66370,61627,23455,14952,20744,9236,3691,35.9,275089,263630,42518,33671,275089,135087,140002,33671,14884,18787
0500000US51121,"Montgomery County, Virginia",98602,50997,47605,4950,3909,4133,16979,13658,14447,10084,9941,3652,5662,6560,3653,974,28.2,82779,64111,14106,11187,82779,42845,39934,11187,5063,6124
0500000US51153,"Prince William County, Virginia",455210,226532,228678,34278,34799,35656,31609,29574,62728,69085,66877,28709,20484,27351,11042,3018,34.9,329426,313819,52387,41411,329426,162532,166894,41411,18500,22911
0500000US51161,"Roanoke County, Virginia",94031,45071,48960,4277,4980,6175,5968,4853,10493,11692,13212,6578,6298,10767,6428,2310,43.5,74901,72196,22830,19505,74901,35216,39685,19505,8411,11094
0500000US51165,"Rockingham County, Virginia",79744,38921,40823,4462,4458,5771,5105,5125,9597,8934,10696,5845,4848,8296,5034,1573,41.8,62084,58836,17494,14903,62084,29611,32473,14903,6749,8154
0500000US51177,"Spotsylvania County, Virginia",132010,65365,66645,7440,9007,10259,10252,7648,15404,17700,20406,9323,7096,11356,4433,1686,39,98957,92708,21670,17475,98957,47769,51188,17475,7741,9734
0500000US51179,"Stafford County, Virginia",144361,72808,71553,9029,11610,10191,11253,10431,17670,20209,23145,9029,7528,9268,3743,1255,35.9,106457,100271,18666,14266,106457,53342,53115,14266,6435,7831
0500000US51199,"York County, Virginia",67976,32325,35651,3690,4441,5494,4999,4365,6883,9442,9409,4307,4662,6105,3024,1155,39.5,51390,48393,12872,10284,51390,24435,26955,10284,4514,5770
0500000US51510,"Alexandria city, Virginia",155810,74560,81250,11363,7460,6702,5753,7553,33476,29727,20508,9463,8097,10023,3783,1902,36.6,127327,123455,20550,15708,127327,60619,66708,15708,6737,8971
0500000US51550,"Chesapeake city, Virginia",237940,116137,121803,15605,16911,14302,15508,14932,35676,30620,34061,16471,14137,18220,8063,3434,36.9,180367,172457,38230,29717,180367,86774,93593,29717,12596,17121
0500000US51650,"Hampton city, Virginia",135410,64156,71254,8006,7294,8730,9000,11387,21867,14623,17048,10285,7875,11139,5902,2254,36.2,106949,99528,24583,19295,106949,50203,56746,19295,7945,11350
0500000US51680,"Lynchburg city, Virginia",80212,35920,44292,4927,4672,2697,9355,14532,10284,6251,8188,3973,3840,5950,3298,2245,27.7,64740,54184,13644,11493,64740,29423,35317,11493,4636,6857
0500000US51700,"Newport News city, Virginia",181825,88786,93039,13046,11842,10689,11787,18252,29759,20136,22876,12069,9152,13148,6440,2629,33.4,139775,131241,27380,22217,139775,67143,72632,22217,8841,13376
0500000US51710,"Norfolk city, Virginia",245115,127741,117374,16583,13839,12440,16386,34096,47028,27187,25459,14890,11924,14719,7028,3536,30.6,195536,178413,31642,25283,195536,102527,93009,25283,10588,14695
0500000US51740,"Portsmouth city, Virginia",95252,45634,49618,6962,6748,5366,6091,7716,14774,11010,11115,6719,5369,7547,3866,1969,35,72747,67731,16435,13382,72747,34462,38285,13382,5435,7947
0500000US51760,"Richmond city, Virginia",223170,106262,116908,13130,12615,8657,15880,19079,48358,26049,25717,13139,13963,16047,6723,3813,33.4,183142,169444,33964,26583,183142,85860,97282,26583,11051,15532
0500000US51770,"Roanoke city, Virginia",99660,47335,52325,6639,7259,5119,5655,5126,14750,13422,13299,7280,5921,8665,4342,2183,38.7,77385,74587,18762,15190,77385,35875,41510,15190,6163,9027
0500000US51800,"Suffolk city, Virginia",89273,43617,45656,5754,5465,7090,5914,5547,10924,11780,13055,6219,5305,7514,3448,1258,38.2,67174,64182,14956,12220,67174,32144,35030,12220,5498,6722
0500000US51810,"Virginia Beach city, Virginia",452602,222398,230204,29127,24995,30844,27460,33588,75365,58150,58740,29152,25591,35486,17471,6633,35.8,350825,333512,73678,59590,350825,170662,180163,59590,25535,34055
0500000US53005,"Benton County, Washington",193686,96102,97584,13319,15927,13943,13723,11943,25765,24281,22990,11922,12458,16428,8055,2932,35.6,141809,134878,33922,27415,141809,69804,72005,27415,12686,14729
0500000US53007,"Chelan County, Washington",76338,38152,38186,4895,6514,4016,4427,4962,8489,8621,9556,5669,5106,7859,3945,2279,40.3,58029,55371,17298,14083,58029,28526,29503,14083,6369,7714
0500000US53009,"Clallam County, Washington",74570,36554,38016,3940,4308,3102,3748,3515,7453,7080,8066,5938,6518,12340,6310,2252,50.8,61087,58745,24828,20902,61087,30045,31042,20902,9824,11078
0500000US53011,"Clark County, Washington",467018,230670,236348,29540,34070,30899,31435,26977,60930,61261,63318,29823,30219,42855,18107,7584,38,351954,335341,85640,68546,351954,172211,179743,68546,31292,37254
0500000US53015,"Cowlitz County, Washington",105160,51052,54108,5426,6234,6643,8045,5651,11787,12453,14126,7285,7478,12110,6089,1833,42.4,81337,77793,24609,20032,81337,40000,41337,20032,9220,10812
0500000US53021,"Franklin County, Washington",90160,46542,43618,8241,8701,9261,7414,5549,13547,12088,9539,4187,4427,4460,1932,814,29.3,59494,54928,9574,7206,59494,31041,28453,7206,3309,3897
0500000US53025,"Grant County, Washington",93546,47037,46509,7322,7391,7892,8890,5846,12288,10936,10313,5072,4960,7755,3072,1809,32.9,66270,60476,16661,12636,66270,33384,32886,12636,6246,6390
0500000US53027,"Grays Harbor County, Washington",71628,37737,33891,3795,3479,4775,3840,3571,8240,8714,8908,6646,5229,8908,3534,1989,43.9,57018,54757,17557,14431,57018,29711,27307,14431,6988,7443
0500000US53029,"Island County, Washington",82636,42597,40039,4598,4527,3445,4049,5560,11313,7659,9190,5951,6756,12046,6006,1536,45.4,67682,65459,23504,19588,67682,33854,33828,19588,9441,10147
0500000US53033,"King County, Washington",2149970,1075509,1074461,129311,130976,113177,117750,132714,376944,316291,296929,133991,128755,163659,72166,37307,37.1,1706344,1635775,348405,273132,1706344,849361,856983,273132,121065,152067
0500000US53035,"Kitsap County, Washington",264811,134237,130574,15338,15147,15074,14781,20942,38325,29872,33946,20401,16437,28168,12141,4239,38.5,210154,201367,54746,44548,210154,106547,103607,44548,20412,24136
0500000US53041,"Lewis County, Washington",77066,38991,38075,4025,4362,4598,5177,4586,8189,8752,9569,5160,6121,9990,4352,2185,43.7,60762,58024,19675,16527,60762,30190,30572,16527,8084,8443
0500000US53053,"Pierce County, Washington",861312,427539,433773,58604,57189,55205,53024,61074,130456,110665,112148,55597,52426,69881,30898,14145,36.1,656881,623372,144926,114924,656881,323711,333170,114924,51509,63415
0500000US53057,"Skagit County, Washington",123681,61569,62112,7346,6739,8548,7806,7332,14076,14611,14763,9307,9068,14449,6302,3334,42,96523,91535,28849,24085,96523,47399,49124,24085,11208,12877
0500000US53061,"Snohomish County, Washington",787620,394394,393226,49930,50063,49362,46979,47813,114272,108857,113475,57227,48368,62164,27340,11770,38,608027,581468,129802,101274,608027,302966,305061,101274,45146,56128
0500000US53063,"Spokane County, Washington",499072,248100,250972,30050,29546,32579,33319,35058,72685,60118,62133,33433,33288,45789,21649,9425,37.3,388177,366459,97134,76863,388177,190480,197697,76863,34539,42324
0500000US53067,"Thurston County, Washington",275222,135063,140159,15731,17233,16165,16147,15520,41208,34150,36322,19920,17603,27861,12900,4462,39.5,215447,205877,56891,45223,215447,103793,111654,45223,20290,24933
0500000US53073,"Whatcom County, Washington",216800,107399,109401,11427,11963,12433,14664,23827,28300,24771,26128,13653,13994,22105,8999,4536,37,174197,160002,44243,35640,174197,85239,88958,35640,16488,19152
0500000US53077,"Yakima County, Washington",249636,124709,124927,20478,21859,20357,18894,17175,32288,29325,28509,14817,12302,19423,9925,4284,32.8,174986,165174,40710,33632,174986,86797,88189,33632,15410,18222
0500000US54003,"Berkeley County, West Virginia",113525,55447,58078,7164,8551,7249,5476,6634,16565,15128,15939,7646,7161,10604,3988,1420,38.2,86318,83537,19739,16012,86318,41430,44888,16012,7276,8736
0500000US54011,"Cabell County, West Virginia",95987,46975,49012,5730,5388,4990,7820,9065,11846,10869,11396,6327,5809,9515,5569,1663,38,76577,70198,20111,16747,76577,36623,39954,16747,7068,9679
0500000US54033,"Harrison County, West Virginia",68400,33222,35178,4210,3248,4774,3489,3856,8502,8269,9024,4909,5326,7336,3986,1471,41.8,53608,51862,15583,12793,53608,25608,28000,12793,5425,7368
0500000US54039,"Kanawha County, West Virginia",186241,88537,97704,10158,11654,9810,9152,10502,23417,22377,25176,14984,13577,20970,10392,4072,43.4,148423,143487,43168,35434,148423,70757,77666,35434,15291,20143
0500000US54061,"Monongalia County, West Virginia",104622,53431,51191,5632,4772,4036,9263,16526,18051,11687,10975,6652,4543,7903,3333,1249,31.4,87239,76497,15232,12485,87239,44726,42513,12485,5592,6893
0500000US54081,"Raleigh County, West Virginia",76601,38557,38044,4637,3614,5143,4383,3669,9228,11014,9015,5288,5674,8770,4035,2131,41.2,60426,58183,18572,14936,60426,30165,30261,14936,6700,8236
0500000US54107,"Wood County, West Virginia",85643,40920,44723,4920,4064,5930,4890,4954,9939,10118,11625,6781,5784,9643,5001,1994,43,67470,64294,19715,16638,67470,32114,35356,16638,7318,9320
0500000US55009,"Brown County, Wisconsin",260401,130129,130272,16994,18563,16284,17512,17350,35457,32264,35735,18478,16119,20496,10972,4177,37.1,197772,187045,45193,35645,197772,97345,100427,35645,16106,19539
0500000US55025,"Dane County, Wisconsin",531273,263187,268086,31099,29261,32335,36196,55433,81622,70093,64233,33855,29330,40531,17961,9324,35,420348,390635,85106,67816,420348,206818,213530,67816,30456,37360
0500000US55027,"Dodge County, Wisconsin",88068,46565,41503,4154,4663,5808,5072,5107,11022,10940,13077,6885,6297,8147,4153,2743,42.1,70250,67123,18929,15043,70250,37411,32839,15043,6833,8210
0500000US55035,"Eau Claire County, Wisconsin",102965,50998,51967,5873,6243,5890,8169,12810,13975,10740,11287,6145,6765,8657,4017,2394,34.2,81469,74674,19064,15068,81469,39945,41524,15068,6706,8362
0500000US55039,"Fond du Lac County, Wisconsin",102144,49848,52296,5577,6575,6158,6258,6507,12155,11594,14470,7984,7120,10053,5185,2508,41,79864,75893,22365,17746,79864,38549,41315,17746,7962,9784
0500000US55055,"Jefferson County, Wisconsin",84625,42562,42063,4005,5195,5777,6472,5532,9878,9866,12071,6630,5709,8027,4087,1376,39.6,66132,61533,16604,13490,66132,32805,33327,13490,6248,7242
0500000US55059,"Kenosha County, Wisconsin",168183,82871,85312,9756,10898,11683,12153,12017,20713,20116,25703,11758,11483,12559,6751,2593,39,128731,121452,28557,21903,128731,62821,65910,21903,9512,12391
0500000US55063,"La Crosse County, Wisconsin",118122,56961,61161,6940,5937,6649,9140,14084,15601,12997,13649,8280,6624,10189,5246,2786,35.5,94565,86437,21911,18221,94565,45372,49193,18221,8083,10138
0500000US55071,"Manitowoc County, Wisconsin",79536,39441,40095,4237,5413,4071,4529,4418,8529,8988,11200,6308,6448,8391,5322,1682,44.6,63003,60552,18753,15395,63003,31007,31996,15395,6934,8461
0500000US55073,"Marathon County, Wisconsin",135603,67858,67745,7815,9505,8399,8645,7983,15803,16016,19203,10023,9268,12875,6969,3099,40.8,104515,99868,28335,22943,104515,52427,52088,22943,10644,12299
0500000US55079,"Milwaukee County, Wisconsin",951448,460687,490761,66573,66081,61440,63154,67767,155894,120143,114781,62840,52359,67833,32440,20143,34.7,720314,678726,151173,120416,720314,343051,377263,120416,50712,69704
0500000US55087,"Outagamie County, Wisconsin",184526,91828,92698,11265,12873,12185,12473,11230,24488,23363,26695,13055,11532,14765,6750,3852,38.2,140535,134112,32011,25367,140535,68732,71803,25367,11185,14182
0500000US55089,"Ozaukee County, Wisconsin",88314,42960,45354,4606,4153,6545,6384,5376,8716,9937,12523,7392,6113,9145,4959,2465,44,69174,65249,20056,16569,69174,33224,35950,16569,7401,9168
0500000US55097,"Portage County, Wisconsin",70447,34966,35481,3661,3564,4009,5495,8482,8491,7480,8792,4734,4746,6404,3512,1077,36.6,56962,51674,14215,10993,56962,28416,28546,10993,5139,5854
0500000US55101,"Racine County, Wisconsin",195140,96418,98722,12043,13231,12073,12571,12352,23514,23114,28027,15527,11696,18215,8815,3962,40,149612,142297,37524,30992,149612,73248,76364,30992,13906,17086
0500000US55105,"Rock County, Wisconsin",161620,79531,82089,9712,10896,11214,10123,10243,19491,18833,23278,11241,10917,14806,7917,2949,40.1,123395,117236,31810,25672,123395,59538,63857,25672,11266,14406
0500000US55109,"St. Croix County, Wisconsin",88029,43967,44062,5270,7867,5135,6005,4366,10217,12251,13208,6637,5430,7090,3301,1252,38.3,65625,62702,14572,11643,65625,32670,32955,11643,5476,6167
0500000US55117,"Sheboygan County, Wisconsin",115427,58200,57227,6378,8380,6173,7597,6257,13273,14453,15925,8283,8588,11001,6389,2730,41.5,89465,85395,24682,20120,89465,44749,44716,20120,9023,11097
0500000US55127,"Walworth County, Wisconsin",102959,51364,51595,5389,6099,6769,7134,10114,10716,11499,14017,8883,5662,9869,4690,2118,39.9,80806,74649,20073,16677,80806,39826,40980,16677,7688,8989
0500000US55131,"Washington County, Wisconsin",134296,66215,68081,7418,9258,8228,8427,6658,13960,16464,21031,11312,8818,12892,6017,3813,42.9,103890,99544,28282,22722,103890,51232,52658,22722,10198,12524
0500000US55133,"Waukesha County, Wisconsin",398424,195314,203110,19808,22828,27058,27026,21513,41653,47853,58977,33379,28256,38977,21460,9636,43.2,311352,297818,85130,70073,311352,151158,160194,70073,31082,38991
0500000US55139,"Winnebago County, Wisconsin",169886,86078,83808,9120,9777,9798,11327,15583,21888,19925,23313,12679,9996,14754,8560,3166,38.6,134955,126678,32669,26480,134955,68040,66915,26480,11774,14706
0500000US55141,"Wood County, Wisconsin",73107,35526,37581,3878,4140,4780,4129,3960,8451,7960,10311,7022,4258,7747,4269,2202,44.1,57586,55780,16823,14218,57586,27918,29668,14218,6280,7938
0500000US56021,"Laramie County, Wyoming",98136,50128,48008,6421,7532,5371,5918,5655,16097,10820,12700,6542,6253,8593,4232,2002,36.4,75246,71548,19136,14827,75246,38442,36804,14827,6816,8011
0500000US56025,"Natrona County, Wyoming",81039,39821,41218,4873,5483,5647,6104,4939,11947,10590,9360,6304,4834,6449,2912,1597,36,61189,57359,13730,10958,61189,30202,30987,10958,4770,6188
0500000US72013,"Arecibo Municipio, Puerto Rico",87939,42144,45795,4029,4200,5350,5958,6217,10572,11014,11935,6060,4659,9995,6330,1620,42.8,70767,66735,20486,17945,70767,33263,37504,17945,7648,10297
0500000US72021,"Bayamón Municipio, Puerto Rico",184374,87165,97209,8195,9757,9858,12066,13081,25124,22176,23549,11374,11711,18992,13344,5147,41.2,149442,141772,44471,37483,149442,69105,80337,37483,15323,22160
0500000US72025,"Caguas Municipio, Puerto Rico",132164,61485,70679,5902,6677,8822,8973,9151,16574,17191,17710,8684,7547,13714,7606,3613,40.7,105315,100264,29409,24933,105315,47776,57539,24933,10187,14746
0500000US72031,"Carolina Municipio, Puerto Rico",158457,72547,85910,7214,8300,8934,10566,11292,19250,20159,21018,10345,8236,17869,11706,3568,42,127608,120748,37634,33143,127608,56914,70694,33143,13321,19822
0500000US72061,"Guaynabo Municipio, Puerto Rico",89307,42079,47228,3698,3929,4917,5298,5969,11294,11136,12283,6506,5955,9800,5927,2595,43.4,73565,70683,20909,18322,73565,33975,39590,18322,7560,10762
0500000US72097,"Mayagüez Municipio, Puerto Rico",77748,37108,40640,3277,4185,3744,6248,8695,8790,7493,8334,4486,4973,9337,6511,1675,40.6,63673,57520,20268,17523,63673,29855,33818,17523,7184,10339
0500000US72113,"Ponce Municipio, Puerto Rico",145278,69855,75423,7672,8811,8044,10265,10722,18329,16657,17039,9960,8723,16307,9920,2829,40.7,114715,107959,33747,29056,114715,54232,60483,29056,12418,16638
0500000US72127,"San Juan Municipio, Puerto Rico",347052,158826,188226,16365,16437,19684,22406,24029,43785,41308,44816,21033,24007,37341,23967,11874,42.3,281526,267338,86447,73182,281526,125660,155866,73182,29281,43901
0500000US72135,"Toa Alta Municipio, Puerto Rico",73980,35531,38449,3437,4448,5029,5641,5611,9744,10499,11048,4352,4573,5856,2340,1402,38.1,57610,54689,12863,9598,57610,27121,30489,9598,4296,5302
0500000US72137,"Toa Baja Municipio, Puerto Rico",80207,37574,42633,3935,4571,4712,5656,5519,10657,10501,10341,5286,4567,8375,4468,1619,39.9,63512,60508,17280,14462,63512,29060,34452,14462,6204,8258
0500000US72139,"Trujillo Alto Municipio, Puerto Rico",68242,32114,36128,3060,3072,5247,4208,5226,8613,9168,9206,4044,4406,7000,3784,1208,40,54044,51738,14989,11992,54044,24690,29354,11992,5036,6956
